PCON11CD,PCON11NM,Total Rural population 2011,Urban City and Town population 2011,Urban Minor Conurbation population 2011,Urban Major Conurbation population 2011,Total Urban population 2011,Total population 2011,Hub towns (rural related) population included in Urban population 2011,Rural including hub towns (rural & rural related) population 2011,Rural including hub towns (rural & rural related) population as % of Total population 2011,RUC11CD,RUC11,Broad RUC11
E14000530,Aldershot,1615,102307,0,0,102307,103922,0,1615,1.55,4,Urban with City and Town,Predominantly Urban
E14000531,Aldridge-Brownhills,2721,338,0,73915,74253,76974,0,2721,3.53,6,Urban with Major Conurbation,Predominantly Urban
E14000532,Altrincham and Sale West,824,4048,0,91719,95767,96591,0,824,0.85,6,Urban with Major Conurbation,Predominantly Urban
E14000533,Amber Valley,15483,5795,66605,0,72400,87883,0,15483,17.61,5,Urban with Minor Conurbation,Predominantly Urban
E14000534,Arundel and South Downs,77072,20195,0,0,20195,97267,0,77072,79.23,2,Largely Rural (rural including hub towns 50-79%) ,Predominantly Rural
E14000535,Ashfield,905,85715,15294,0,101009,101914,0,905,0.88,4,Urban with City and Town,Predominantly Urban
E14000536,Ashford,38207,74733,0,0,74733,112940,0,38207,33.82,3,Urban with Significant Rural (rural including hub towns 26-49%),Urban with Significant Rural
E14000537,Ashton-under-Lyne,358,0,0,90126,90126,90484,0,358,0.39,6,Urban with Major Conurbation,Predominantly Urban
E14000538,Aylesbury,26222,81805,0,0,81805,108027,0,26222,24.27,4,Urban with City and Town,Predominantly Urban
E14000539,Banbury,35431,82497,0,0,82497,117928,0,35431,30.04,3,Urban with Significant Rural (rural including hub towns 26-49%),Urban with Significant Rural
E14000540,Barking,0,0,0,122313,122313,122313,0,0,0,6,Urban with Major Conurbation,Predominantly Urban
E14000541,Barnsley Central,0,3093,82621,0,85714,85714,0,0,0,5,Urban with Minor Conurbation,Predominantly Urban
E14000542,Barnsley East,11866,6553,72015,0,78568,90434,0,11866,13.12,5,Urban with Minor Conurbation,Predominantly Urban
E14000543,Barrow and Furness,31605,57221,0,0,57221,88826,11356,42961,48.36,3,Urban with Significant Rural (rural including hub towns 26-49%),Urban with Significant Rural
E14000544,Basildon and Billericay,249,89438,0,0,89438,89687,0,249,0.27,4,Urban with City and Town,Predominantly Urban
E14000545,Basingstoke,851,107145,0,0,107145,107996,0,851,0.78,4,Urban with City and Town,Predominantly Urban
E14000546,Bassetlaw,38533,65275,0,0,65275,103808,22023,60556,58.33,2,Largely Rural (rural including hub towns 50-79%) ,Predominantly Rural
E14000547,Bath,576,88283,0,0,88283,88859,0,576,0.64,4,Urban with City and Town,Predominantly Urban
E14000548,Batley and Spen,609,1595,0,105695,107290,107899,0,609,0.56,6,Urban with Major Conurbation,Predominantly Urban
E14000549,Battersea,0,0,0,106709,106709,106709,0,0,0,6,Urban with Major Conurbation,Predominantly Urban
E14000550,Beaconsfield,22058,75883,0,1446,77329,99387,14325,36383,36.6,3,Urban with Significant Rural (rural including hub towns 26-49%),Urban with Significant Rural
E14000551,Beckenham,134,1277,0,85600,86877,87011,0,134,0.15,6,Urban with Major Conurbation,Predominantly Urban
E14000552,Bedford,701,100365,0,0,100365,101066,0,701,0.69,4,Urban with City and Town,Predominantly Urban
E14000553,Bermondsey and Old Southwark,0,0,0,126522,126522,126522,0,0,0,6,Urban with Major Conurbation,Predominantly Urban
E14000554,Berwick-upon-Tweed,62453,13265,0,0,13265,75718,13265,75718,100,1,Mainly Rural (rural including hub towns >=80%) ,Predominantly Rural
E14000555,Bethnal Green and Bow,0,0,0,125351,125351,125351,0,0,0,6,Urban with Major Conurbation,Predominantly Urban
E14000556,Beverley and Holderness,56727,43021,0,0,43021,99748,0,56727,56.87,2,Largely Rural (rural including hub towns 50-79%) ,Predominantly Rural
E14000557,Bexhill and Battle,54479,46248,0,0,46248,100727,0,54479,54.08,2,Largely Rural (rural including hub towns 50-79%) ,Predominantly Rural
E14000558,Bexleyheath and Crayford,0,0,0,87848,87848,87848,0,0,0,6,Urban with Major Conurbation,Predominantly Urban
E14000559,Birkenhead,0,0,0,88818,88818,88818,0,0,0,6,Urban with Major Conurbation,Predominantly Urban
E14000560,"Birmingham, Edgbaston",0,0,0,96568,96568,96568,0,0,0,6,Urban with Major Conurbation,Predominantly Urban
E14000561,"Birmingham, Erdington",0,0,0,97778,97778,97778,0,0,0,6,Urban with Major Conurbation,Predominantly Urban
E14000562,"Birmingham, Hall Green",0,0,0,115904,115904,115904,0,0,0,6,Urban with Major Conurbation,Predominantly Urban
E14000563,"Birmingham, Hodge Hill",0,0,0,121678,121678,121678,0,0,0,6,Urban with Major Conurbation,Predominantly Urban
E14000564,"Birmingham, Ladywood",0,0,0,126693,126693,126693,0,0,0,6,Urban with Major Conurbation,Predominantly Urban
E14000565,"Birmingham, Northfield",0,0,0,101422,101422,101422,0,0,0,6,Urban with Major Conurbation,Predominantly Urban
E14000566,"Birmingham, Perry Barr",0,0,0,107090,107090,107090,0,0,0,6,Urban with Major Conurbation,Predominantly Urban
E14000567,"Birmingham, Selly Oak",0,0,0,104067,104067,104067,0,0,0,6,Urban with Major Conurbation,Predominantly Urban
E14000568,"Birmingham, Yardley",0,0,0,106738,106738,106738,0,0,0,6,Urban with Major Conurbation,Predominantly Urban
E14000569,Bishop Auckland,43327,43816,0,0,43816,87143,26050,69377,79.61,2,Largely Rural (rural including hub towns 50-79%) ,Predominantly Rural
E14000570,Blackburn,446,106800,0,0,106800,107246,0,446,0.41,4,Urban with City and Town,Predominantly Urban
E14000571,Blackley and Broughton,0,0,0,110754,110754,110754,0,0,0,6,Urban with Major Conurbation,Predominantly Urban
E14000572,Blackpool North and Cleveleys,555,82836,0,0,82836,83391,0,555,0.66,4,Urban with City and Town,Predominantly Urban
E14000573,Blackpool South,0,81266,0,0,81266,81266,0,0,0,4,Urban with City and Town,Predominantly Urban
E14000574,Blaydon,16063,2861,0,69357,72218,88281,0,16063,18.19,6,Urban with Major Conurbation,Predominantly Urban
E14000575,Blyth Valley,17152,38323,0,26699,65022,82174,0,17152,20.87,4,Urban with City and Town,Predominantly Urban
E14000576,Bognor Regis and Littlehampton,6753,91680,0,0,91680,98433,0,6753,6.86,4,Urban with City and Town,Predominantly Urban
E14000577,Bolsover,44887,35110,14476,0,49586,94473,0,44887,47.51,3,Urban with Significant Rural (rural including hub towns 26-49%),Urban with Significant Rural
E14000578,Bolton North East,272,1635,0,93381,95016,95288,0,272,0.28,6,Urban with Major Conurbation,Predominantly Urban
E14000579,Bolton South East,202,1206,0,100339,101545,101747,0,202,0.19,6,Urban with Major Conurbation,Predominantly Urban
E14000580,Bolton West,2014,24595,0,67914,92509,94523,0,2014,2.13,6,Urban with Major Conurbation,Predominantly Urban
E14000581,Bootle,0,0,0,98449,98449,98449,0,0,0,6,Urban with Major Conurbation,Predominantly Urban
E14000582,Boston and Skegness,38852,62832,0,0,62832,101684,21492,60344,59.34,2,Largely Rural (rural including hub towns 50-79%) ,Predominantly Rural
E14000583,Bosworth,33300,64982,0,0,64982,98282,19733,53033,53.96,2,Largely Rural (rural including hub towns 50-79%) ,Predominantly Rural
E14000584,Bournemouth East,139,102013,0,0,102013,102152,0,139,0.13,4,Urban with City and Town,Predominantly Urban
E14000585,Bournemouth West,0,98968,0,0,98968,98968,0,0,0,4,Urban with City and Town,Predominantly Urban
E14000586,Bracknell,2395,102454,0,0,102454,104849,0,2395,2.28,4,Urban with City and Town,Predominantly Urban
E14000587,Bradford East,0,0,0,113820,113820,113820,0,0,0,6,Urban with Major Conurbation,Predominantly Urban
E14000588,Bradford South,1402,906,0,99237,100143,101545,0,1402,1.38,6,Urban with Major Conurbation,Predominantly Urban
E14000589,Bradford West,1949,1377,0,111435,112812,114761,0,1949,1.69,6,Urban with Major Conurbation,Predominantly Urban
E14000590,Braintree,32755,65085,0,0,65085,97840,11906,44661,45.64,3,Urban with Significant Rural (rural including hub towns 26-49%),Urban with Significant Rural
E14000591,Brent Central,0,0,0,137438,137438,137438,0,0,0,6,Urban with Major Conurbation,Predominantly Urban
E14000592,Brent North,0,0,0,128484,128484,128484,0,0,0,6,Urban with Major Conurbation,Predominantly Urban
E14000593,Brentford and Isleworth,0,0,0,128556,128556,128556,0,0,0,6,Urban with Major Conurbation,Predominantly Urban
E14000594,Brentwood and Ongar,39413,53544,0,0,53544,92957,0,39413,42.39,3,Urban with Significant Rural (rural including hub towns 26-49%),Urban with Significant Rural
E14000595,Bridgwater and West Somerset,52912,53538,0,0,53538,106450,12262,65174,61.22,2,Largely Rural (rural including hub towns 50-79%) ,Predominantly Rural
E14000596,Brigg and Goole,62119,24587,0,0,24587,86706,20810,82929,95.64,1,Mainly Rural (rural including hub towns >=80%) ,Predominantly Rural
E14000597,"Brighton, Kemptown",1089,90478,0,0,90478,91567,0,1089,1.18,4,Urban with City and Town,Predominantly Urban
E14000598,"Brighton, Pavilion",3229,100364,0,0,100364,103593,0,3229,3.11,4,Urban with City and Town,Predominantly Urban
E14000599,Bristol East,0,95368,0,0,95368,95368,0,0,0,4,Urban with City and Town,Predominantly Urban
E14000600,Bristol North West,0,100809,0,0,100809,100809,0,0,0,4,Urban with City and Town,Predominantly Urban
E14000601,Bristol South,0,107365,0,0,107365,107365,0,0,0,4,Urban with City and Town,Predominantly Urban
E14000602,Bristol West,0,124692,0,0,124692,124692,0,0,0,4,Urban with City and Town,Predominantly Urban
E14000603,Broadland,77287,17901,0,0,17901,95188,0,77287,81.19,1,Mainly Rural (rural including hub towns >=80%) ,Predominantly Rural
E14000604,Bromley and Chislehurst,0,0,0,88633,88633,88633,0,0,0,6,Urban with Major Conurbation,Predominantly Urban
E14000605,Bromsgrove,19619,55122,0,18896,74018,93637,0,19619,20.95,4,Urban with City and Town,Predominantly Urban
E14000606,Broxbourne,5335,3024,0,90431,93455,98790,0,5335,5.4,6,Urban with Major Conurbation,Predominantly Urban
E14000607,Broxtowe,423,0,94548,0,94548,94971,0,423,0.44,5,Urban with Minor Conurbation,Predominantly Urban
E14000608,Buckingham,82589,14595,0,0,14595,97184,12890,95479,98.24,1,Mainly Rural (rural including hub towns >=80%) ,Predominantly Rural
E14000609,Burnley,4483,82576,0,0,82576,87059,0,4483,5.14,4,Urban with City and Town,Predominantly Urban
E14000610,Burton,15322,87409,0,0,87409,102731,13089,28411,27.65,3,Urban with Significant Rural (rural including hub towns 26-49%),Urban with Significant Rural
E14000611,Bury North,2543,239,0,84436,84675,87218,0,2543,2.91,6,Urban with Major Conurbation,Predominantly Urban
E14000612,Bury South,2583,480,0,94779,95259,97842,0,2583,2.63,6,Urban with Major Conurbation,Predominantly Urban
E14000613,Bury St Edmunds,49838,63840,0,0,63840,113678,21028,70866,62.33,2,Largely Rural (rural including hub towns 50-79%) ,Predominantly Rural
E14000614,Calder Valley,36700,14152,0,52109,66261,102961,11690,48390,46.99,3,Urban with Significant Rural (rural including hub towns 26-49%),Urban with Significant Rural
E14000615,Camberwell and Peckham,0,0,0,125226,125226,125226,0,0,0,6,Urban with Major Conurbation,Predominantly Urban
E14000616,Camborne and Redruth,39648,45788,0,0,45788,85436,0,39648,46.4,3,Urban with Significant Rural (rural including hub towns 26-49%),Urban with Significant Rural
E14000617,Cambridge,359,114381,0,0,114381,114740,0,359,0.31,4,Urban with City and Town,Predominantly Urban
E14000618,Cannock Chase,10767,25355,0,61340,86695,97462,24033,34800,35.7,3,Urban with Significant Rural (rural including hub towns 26-49%),Urban with Significant Rural
E14000619,Canterbury,21940,87340,0,0,87340,109280,0,21940,20.07,4,Urban with City and Town,Predominantly Urban
E14000620,Carlisle,8891,77088,0,0,77088,85979,0,8891,10.34,4,Urban with City and Town,Predominantly Urban
E14000621,Carshalton and Wallington,0,427,0,94895,95322,95322,0,0,0,6,Urban with Major Conurbation,Predominantly Urban
E14000622,Castle Point,0,88011,0,0,88011,88011,0,0,0,4,Urban with City and Town,Predominantly Urban
E14000623,Central Devon,88400,526,0,0,526,88926,0,88400,99.4,1,Mainly Rural (rural including hub towns >=80%) ,Predominantly Rural
E14000624,Central Suffolk and North Ipswich,51036,47899,0,0,47899,98935,905,51941,52.5,2,Largely Rural (rural including hub towns 50-79%) ,Predominantly Rural
E14000625,Charnwood,19055,75693,0,0,75693,94748,0,19055,20.11,4,Urban with City and Town,Predominantly Urban
E14000626,Chatham and Aylesford,4845,92436,0,0,92436,97281,0,4845,4.98,4,Urban with City and Town,Predominantly Urban
E14000627,Cheadle,0,647,0,90376,91023,91023,0,0,0,6,Urban with Major Conurbation,Predominantly Urban
E14000628,Chelmsford,161,105263,0,0,105263,105424,0,161,0.15,4,Urban with City and Town,Predominantly Urban
E14000629,Chelsea and Fulham,0,0,0,105697,105697,105697,0,0,0,6,Urban with Major Conurbation,Predominantly Urban
E14000630,Cheltenham,327,104540,0,0,104540,104867,0,327,0.31,4,Urban with City and Town,Predominantly Urban
E14000631,Chesham and Amersham,26030,66605,0,0,66605,92635,0,26030,28.09,3,Urban with Significant Rural (rural including hub towns 26-49%),Urban with Significant Rural
E14000632,Chesterfield,1670,91578,0,0,91578,93248,0,1670,1.79,4,Urban with City and Town,Predominantly Urban
E14000633,Chichester,50892,53482,0,0,53482,104374,12543,63435,60.77,2,Largely Rural (rural including hub towns 50-79%) ,Predominantly Rural
E14000634,Chingford and Woodford Green,0,0,0,88149,88149,88149,0,0,0,6,Urban with Major Conurbation,Predominantly Urban
E14000635,Chippenham,23088,73248,0,0,73248,96336,19357,42445,44.05,3,Urban with Significant Rural (rural including hub towns 26-49%),Urban with Significant Rural
E14000636,Chipping Barnet,0,753,0,111220,111973,111973,0,0,0,6,Urban with Major Conurbation,Predominantly Urban
E14000637,Chorley,20843,74089,0,0,74089,94932,0,20843,21.95,4,Urban with City and Town,Predominantly Urban
E14000638,Christchurch,7632,75964,0,0,75964,83596,0,7632,9.12,4,Urban with City and Town,Predominantly Urban
E14000639,Cities of London and Westminster,0,0,0,110000,110000,110000,0,0,0,6,Urban with Major Conurbation,Predominantly Urban
E14000640,City of Chester,9631,83364,0,0,83364,92995,0,9631,10.35,4,Urban with City and Town,Predominantly Urban
E14000641,City of Durham,46590,47785,0,0,47785,94375,0,46590,49.36,3,Urban with Significant Rural (rural including hub towns 26-49%),Urban with Significant Rural
E14000642,Clacton,17353,68006,0,0,68006,85359,17458,34811,40.78,3,Urban with Significant Rural (rural including hub towns 26-49%),Urban with Significant Rural
E14000643,Cleethorpes,25860,67733,0,0,67733,93593,10750,36610,39.11,3,Urban with Significant Rural (rural including hub towns 26-49%),Urban with Significant Rural
E14000644,Colchester,345,108265,0,0,108265,108610,0,345,0.31,4,Urban with City and Town,Predominantly Urban
E14000645,Colne Valley,18825,12044,0,78332,90376,109201,0,18825,17.23,6,Urban with Major Conurbation,Predominantly Urban
E14000646,Congleton,17290,74670,0,0,74670,91960,44154,61444,66.81,2,Largely Rural (rural including hub towns 50-79%) ,Predominantly Rural
E14000647,Copeland,55991,24900,0,0,24900,80891,24900,80891,100,1,Mainly Rural (rural including hub towns >=80%) ,Predominantly Rural
E14000648,Corby,53289,56810,0,0,56810,110099,0,53289,48.4,3,Urban with Significant Rural (rural including hub towns 26-49%),Urban with Significant Rural
E14000649,Coventry North East,0,110511,0,0,110511,110511,0,0,0,4,Urban with City and Town,Predominantly Urban
E14000650,Coventry North West,565,100307,0,0,100307,100872,0,565,0.56,4,Urban with City and Town,Predominantly Urban
E14000651,Coventry South,0,105577,0,0,105577,105577,0,0,0,4,Urban with City and Town,Predominantly Urban
E14000652,Crawley,353,106244,0,0,106244,106597,0,353,0.33,4,Urban with City and Town,Predominantly Urban
E14000653,Crewe and Nantwich,14371,92900,0,0,92900,107271,17226,31597,29.45,3,Urban with Significant Rural (rural including hub towns 26-49%),Urban with Significant Rural
E14000654,Croydon Central,0,0,0,114705,114705,114705,0,0,0,6,Urban with Major Conurbation,Predominantly Urban
E14000655,Croydon North,0,0,0,136044,136044,136044,0,0,0,6,Urban with Major Conurbation,Predominantly Urban
E14000656,Croydon South,0,0,0,112629,112629,112629,0,0,0,6,Urban with Major Conurbation,Predominantly Urban
E14000657,Dagenham and Rainham,259,0,0,101831,101831,102090,0,259,0.25,6,Urban with Major Conurbation,Predominantly Urban
E14000658,Darlington,0,91417,0,0,91417,91417,0,0,0,4,Urban with City and Town,Predominantly Urban
E14000659,Dartford,11716,10024,0,81460,91484,103200,0,11716,11.35,6,Urban with Major Conurbation,Predominantly Urban
E14000660,Daventry,65405,28445,0,0,28445,93850,23879,89284,95.13,1,Mainly Rural (rural including hub towns >=80%) ,Predominantly Rural
E14000661,Denton and Reddish,0,0,0,85832,85832,85832,0,0,0,6,Urban with Major Conurbation,Predominantly Urban
E14000662,Derby North,0,100323,0,0,100323,100323,0,0,0,4,Urban with City and Town,Predominantly Urban
E14000663,Derby South,0,109171,0,0,109171,109171,0,0,0,4,Urban with City and Town,Predominantly Urban
E14000664,Derbyshire Dales,63717,14956,0,0,14956,78673,14956,78673,100,1,Mainly Rural (rural including hub towns >=80%) ,Predominantly Rural
E14000665,Devizes,78964,18064,0,0,18064,97028,18064,97028,100,1,Mainly Rural (rural including hub towns >=80%) ,Predominantly Rural
E14000666,Dewsbury,28919,4918,0,76225,81143,110062,0,28919,26.27,3,Urban with Significant Rural (rural including hub towns 26-49%),Urban with Significant Rural
E14000667,Don Valley,24186,27230,47105,0,74335,98521,12234,36420,36.96,3,Urban with Significant Rural (rural including hub towns 26-49%),Urban with Significant Rural
E14000668,Doncaster Central,0,2322,102628,0,104950,104950,0,0,0,5,Urban with Minor Conurbation,Predominantly Urban
E14000669,Doncaster North,17976,15679,65276,0,80955,98931,5061,23037,23.28,5,Urban with Minor Conurbation,Predominantly Urban
E14000670,Dover,25356,72264,0,0,72264,97620,0,25356,25.97,4,Urban with City and Town,Predominantly Urban
E14000671,Dudley North,276,0,0,80942,80942,81218,0,276,0.33,6,Urban with Major Conurbation,Predominantly Urban
E14000672,Dudley South,0,0,0,79648,79648,79648,0,0,0,6,Urban with Major Conurbation,Predominantly Urban
E14000673,Dulwich and West Norwood,0,0,0,110542,110542,110542,0,0,0,6,Urban with Major Conurbation,Predominantly Urban
E14000674,Ealing Central and Acton,0,0,0,119419,119419,119419,0,0,0,6,Urban with Major Conurbation,Predominantly Urban
E14000675,Ealing North,0,0,0,121117,121117,121117,0,0,0,6,Urban with Major Conurbation,Predominantly Urban
E14000676,"Ealing, Southall",0,0,0,97913,97913,97913,0,0,0,6,Urban with Major Conurbation,Predominantly Urban
E14000677,Easington,20349,62420,0,0,62420,82769,0,20349,24.58,4,Urban with City and Town,Predominantly Urban
E14000678,East Devon,35716,58240,0,0,58240,93956,12569,48285,51.39,2,Largely Rural (rural including hub towns 50-79%) ,Predominantly Rural
E14000679,East Ham,0,0,0,149842,149842,149842,0,0,0,6,Urban with Major Conurbation,Predominantly Urban
E14000680,East Hampshire,40709,54573,0,0,54573,95282,54213,94922,99.62,1,Mainly Rural (rural including hub towns >=80%) ,Predominantly Rural
E14000681,East Surrey,31012,41890,0,32172,74062,105074,0,31012,29.51,3,Urban with Significant Rural (rural including hub towns 26-49%),Urban with Significant Rural
E14000682,East Worthing and Shoreham,810,95214,0,0,95214,96024,0,810,0.84,4,Urban with City and Town,Predominantly Urban
E14000683,East Yorkshire,52143,48234,0,0,48234,100377,13080,65223,64.97,2,Largely Rural (rural including hub towns 50-79%) ,Predominantly Rural
E14000684,Eastbourne,167,106685,0,0,106685,106852,0,167,0.15,4,Urban with City and Town,Predominantly Urban
E14000685,Eastleigh,11791,91972,0,0,91972,103763,0,11791,11.36,4,Urban with City and Town,Predominantly Urban
E14000686,Eddisbury,48231,37402,0,0,37402,85633,0,48231,56.32,2,Largely Rural (rural including hub towns 50-79%) ,Predominantly Rural
E14000687,Edmonton,0,0,0,112059,112059,112059,0,0,0,6,Urban with Major Conurbation,Predominantly Urban
E14000688,Ellesmere Port and Neston,7173,79740,0,0,79740,86913,0,7173,8.25,4,Urban with City and Town,Predominantly Urban
E14000689,Elmet and Rothwell,34511,45836,0,19276,65112,99623,13572,48083,48.26,3,Urban with Significant Rural (rural including hub towns 26-49%),Urban with Significant Rural
E14000690,Eltham,0,0,0,89759,89759,89759,0,0,0,6,Urban with Major Conurbation,Predominantly Urban
E14000691,Enfield North,980,0,0,102073,102073,103053,0,980,0.95,6,Urban with Major Conurbation,Predominantly Urban
E14000692,"Enfield, Southgate",498,1817,0,95039,96856,97354,0,498,0.51,6,Urban with Major Conurbation,Predominantly Urban
E14000693,Epping Forest,10145,12737,0,72202,84939,95084,0,10145,10.66,6,Urban with Major Conurbation,Predominantly Urban
E14000694,Epsom and Ewell,2824,0,0,101373,101373,104197,0,2824,2.71,6,Urban with Major Conurbation,Predominantly Urban
E14000695,Erewash,0,5199,88851,0,94050,94050,0,0,0,5,Urban with Minor Conurbation,Predominantly Urban
E14000696,Erith and Thamesmead,0,0,0,110151,110151,110151,0,0,0,6,Urban with Major Conurbation,Predominantly Urban
E14000697,Esher and Walton,2393,19022,0,87659,106681,109074,0,2393,2.19,6,Urban with Major Conurbation,Predominantly Urban
E14000698,Exeter,0,105998,0,0,105998,105998,0,0,0,4,Urban with City and Town,Predominantly Urban
E14000699,Fareham,359,97145,0,0,97145,97504,0,359,0.36,4,Urban with City and Town,Predominantly Urban
E14000700,Faversham and Mid Kent,30292,62512,0,0,62512,92804,19316,49608,53.45,2,Largely Rural (rural including hub towns 50-79%) ,Predominantly Rural
E14000701,Feltham and Heston,0,0,0,125401,125401,125401,0,0,0,6,Urban with Major Conurbation,Predominantly Urban
E14000702,Filton and Bradley Stoke,4921,87730,0,0,87730,92651,0,4921,5.31,4,Urban with City and Town,Predominantly Urban
E14000703,Finchley and Golders Green,0,0,0,120608,120608,120608,0,0,0,6,Urban with Major Conurbation,Predominantly Urban
E14000704,Folkestone and Hythe,46556,66429,0,0,66429,112985,0,46556,41.2,3,Urban with Significant Rural (rural including hub towns 26-49%),Urban with Significant Rural
E14000705,Forest of Dean,59009,27158,0,0,27158,86167,23339,82348,95.56,1,Mainly Rural (rural including hub towns >=80%) ,Predominantly Rural
E14000706,Fylde,17164,64750,0,0,64750,81914,0,17164,20.95,4,Urban with City and Town,Predominantly Urban
E14000707,Gainsborough,70380,21339,0,0,21339,91719,20842,91222,99.45,1,Mainly Rural (rural including hub towns >=80%) ,Predominantly Rural
E14000708,Garston and Halewood,568,0,0,97129,97129,97697,0,568,0.58,6,Urban with Major Conurbation,Predominantly Urban
E14000709,Gateshead,0,0,0,94506,94506,94506,0,0,0,6,Urban with Major Conurbation,Predominantly Urban
E14000710,Gedling,3613,0,88920,0,88920,92533,0,3613,3.9,5,Urban with Minor Conurbation,Predominantly Urban
E14000711,Gillingham and Rainham,1181,97649,0,0,97649,98830,0,1181,1.19,4,Urban with City and Town,Predominantly Urban
E14000712,Gloucester,0,112156,0,0,112156,112156,0,0,0,4,Urban with City and Town,Predominantly Urban
E14000713,Gosport,526,96173,0,0,96173,96699,0,526,0.54,4,Urban with City and Town,Predominantly Urban
E14000714,Grantham and Stamford,29624,74767,0,0,74767,104391,33662,63286,60.62,2,Largely Rural (rural including hub towns 50-79%) ,Predominantly Rural
E14000715,Gravesham,19079,361,0,82280,82641,101720,0,19079,18.75,6,Urban with Major Conurbation,Predominantly Urban
E14000716,Great Grimsby,0,88243,0,0,88243,88243,0,0,0,4,Urban with City and Town,Predominantly Urban
E14000717,Great Yarmouth,33843,63434,0,0,63434,97277,0,33843,34.79,3,Urban with Significant Rural (rural including hub towns 26-49%),Urban with Significant Rural
E14000718,Greenwich and Woolwich,0,0,0,112628,112628,112628,0,0,0,6,Urban with Major Conurbation,Predominantly Urban
E14000719,Guildford,14373,91274,0,0,91274,105647,11967,26340,24.93,4,Urban with City and Town,Predominantly Urban
E14000720,Hackney North and Stoke Newington,625,0,0,127411,127411,128036,0,625,0.48,6,Urban with Major Conurbation,Predominantly Urban
E14000721,Hackney South and Shoreditch,0,0,0,118234,118234,118234,0,0,0,6,Urban with Major Conurbation,Predominantly Urban
E14000722,Halesowen and Rowley Regis,0,250,0,87069,87319,87319,0,0,0,6,Urban with Major Conurbation,Predominantly Urban
E14000723,Halifax,2526,1540,0,96799,98339,100865,0,2526,2.5,6,Urban with Major Conurbation,Predominantly Urban
E14000724,Haltemprice and Howden,28079,60440,0,0,60440,88519,19904,47983,54.2,2,Largely Rural (rural including hub towns 50-79%) ,Predominantly Rural
E14000725,Halton,1841,93154,0,0,93154,94995,0,1841,1.93,4,Urban with City and Town,Predominantly Urban
E14000726,Hammersmith,0,0,0,118236,118236,118236,0,0,0,6,Urban with Major Conurbation,Predominantly Urban
E14000727,Hampstead and Kilburn,0,0,0,129989,129989,129989,0,0,0,6,Urban with Major Conurbation,Predominantly Urban
E14000728,Harborough,21581,79081,0,0,79081,100662,22911,44492,44.19,3,Urban with Significant Rural (rural including hub towns 26-49%),Urban with Significant Rural
E14000729,Harlow,4331,86937,0,895,87832,92163,0,4331,4.69,4,Urban with City and Town,Predominantly Urban
E14000730,Harrogate and Knaresborough,12274,89060,0,0,89060,101334,0,12274,12.11,4,Urban with City and Town,Predominantly Urban
E14000731,Harrow East,601,0,0,103160,103160,103761,0,601,0.57,6,Urban with Major Conurbation,Predominantly Urban
E14000732,Harrow West,0,0,0,104165,104165,104165,0,0,0,6,Urban with Major Conurbation,Predominantly Urban
E14000733,Hartlepool,3173,88855,0,0,88855,92028,0,3173,3.44,4,Urban with City and Town,Predominantly Urban
E14000734,Harwich and North Essex,69011,22159,0,0,22159,91170,20723,89734,98.42,1,Mainly Rural (rural including hub towns >=80%) ,Predominantly Rural
E14000735,Hastings and Rye,16931,91053,0,0,91053,107984,0,16931,15.67,4,Urban with City and Town,Predominantly Urban
E14000736,Havant,1894,89981,0,0,89981,91875,0,1894,2.06,4,Urban with City and Town,Predominantly Urban
E14000737,Hayes and Harlington,0,2791,0,107342,110133,110133,0,0,0,6,Urban with Major Conurbation,Predominantly Urban
E14000738,Hazel Grove,1249,6666,0,71258,77924,79173,0,1249,1.57,6,Urban with Major Conurbation,Predominantly Urban
E14000739,Hemel Hempstead,7110,2302,0,89672,91974,99084,1356,8466,8.54,6,Urban with Major Conurbation,Predominantly Urban
E14000740,Hemsworth,46973,31994,0,14752,46746,93719,18899,65872,70.28,2,Largely Rural (rural including hub towns 50-79%) ,Predominantly Rural
E14000741,Hendon,0,0,0,123805,123805,123805,0,0,0,6,Urban with Major Conurbation,Predominantly Urban
E14000742,Henley,65999,31813,0,0,31813,97812,24030,90029,92.04,1,Mainly Rural (rural including hub towns >=80%) ,Predominantly Rural
E14000743,Hereford and South Herefordshire,28139,69353,0,0,69353,97492,10582,38721,39.71,3,Urban with Significant Rural (rural including hub towns 26-49%),Urban with Significant Rural
E14000744,Hertford and Stortford,11118,92844,0,2749,95593,106711,0,11118,10.41,4,Urban with City and Town,Predominantly Urban
E14000745,Hertsmere,15024,24225,0,60782,85007,100031,0,15024,15.01,6,Urban with Major Conurbation,Predominantly Urban
E14000746,Hexham,42638,33598,0,0,33598,76236,23463,66101,86.7,1,Mainly Rural (rural including hub towns >=80%) ,Predominantly Rural
E14000747,Heywood and Middleton,1586,1261,0,101047,102308,103894,0,1586,1.52,6,Urban with Major Conurbation,Predominantly Urban
E14000748,High Peak,27861,31951,0,31080,63031,90892,22115,49976,54.98,2,Largely Rural (rural including hub towns 50-79%) ,Predominantly Rural
E14000749,Hitchin and Harpenden,22793,76814,0,0,76814,99607,0,22793,22.88,4,Urban with City and Town,Predominantly Urban
E14000750,Holborn and St Pancras,0,0,0,135642,135642,135642,0,0,0,6,Urban with Major Conurbation,Predominantly Urban
E14000751,Hornchurch and Upminster,1601,0,0,101245,101245,102846,0,1601,1.55,6,Urban with Major Conurbation,Predominantly Urban
E14000752,Hornsey and Wood Green,0,0,0,125689,125689,125689,0,0,0,6,Urban with Major Conurbation,Predominantly Urban
E14000753,Horsham,41417,62275,0,0,62275,103692,0,41417,39.94,3,Urban with Significant Rural (rural including hub towns 26-49%),Urban with Significant Rural
E14000754,Houghton and Sunderland South,1493,916,0,84593,85509,87002,0,1493,1.71,6,Urban with Major Conurbation,Predominantly Urban
E14000755,Hove,0,99753,0,0,99753,99753,0,0,0,4,Urban with City and Town,Predominantly Urban
E14000756,Huddersfield,565,3367,0,91364,94731,95296,0,565,0.59,6,Urban with Major Conurbation,Predominantly Urban
E14000757,Huntingdon,38956,73708,0,0,73708,112664,43456,82412,73.14,2,Largely Rural (rural including hub towns 50-79%) ,Predominantly Rural
E14000758,Hyndburn,8281,84213,0,0,84213,92494,0,8281,8.95,4,Urban with City and Town,Predominantly Urban
E14000759,Ilford North,0,0,0,102589,102589,102589,0,0,0,6,Urban with Major Conurbation,Predominantly Urban
E14000760,Ilford South,0,0,0,131035,131035,131035,0,0,0,6,Urban with Major Conurbation,Predominantly Urban
E14000761,Ipswich,0,109003,0,0,109003,109003,0,0,0,4,Urban with City and Town,Predominantly Urban
E14000762,Isle of Wight,44699,93566,0,0,93566,138265,93566,138265,100,1,Mainly Rural (rural including hub towns >=80%) ,Predominantly Rural
E14000763,Islington North,0,0,0,103469,103469,103469,0,0,0,6,Urban with Major Conurbation,Predominantly Urban
E14000764,Islington South and Finsbury,0,0,0,102656,102656,102656,0,0,0,6,Urban with Major Conurbation,Predominantly Urban
E14000765,Jarrow,433,881,0,81946,82827,83260,0,433,0.52,6,Urban with Major Conurbation,Predominantly Urban
E14000766,Keighley,17295,79855,0,0,79855,97150,14809,32104,33.04,3,Urban with Significant Rural (rural including hub towns 26-49%),Urban with Significant Rural
E14000767,Kenilworth and Southam,50799,31376,0,0,31376,82175,0,50799,61.81,2,Largely Rural (rural including hub towns 50-79%) ,Predominantly Rural
E14000768,Kensington,0,0,0,117209,117209,117209,0,0,0,6,Urban with Major Conurbation,Predominantly Urban
E14000769,Kettering,19103,74372,0,0,74372,93475,0,19103,20.43,4,Urban with City and Town,Predominantly Urban
E14000770,Kingston and Surbiton,424,0,0,117578,117578,118002,0,424,0.35,6,Urban with Major Conurbation,Predominantly Urban
E14000771,Kingston upon Hull East,0,91937,0,0,91937,91937,0,0,0,4,Urban with City and Town,Predominantly Urban
E14000772,Kingston upon Hull North,0,94813,0,0,94813,94813,0,0,0,4,Urban with City and Town,Predominantly Urban
E14000773,Kingston upon Hull West and Hessle,0,84656,0,0,84656,84656,0,0,0,4,Urban with City and Town,Predominantly Urban
E14000774,Kingswood,1257,85933,0,0,85933,87190,0,1257,1.44,4,Urban with City and Town,Predominantly Urban
E14000775,Knowsley,299,3081,0,100530,103611,103910,0,299,0.28,6,Urban with Major Conurbation,Predominantly Urban
E14000776,Lancaster and Fleetwood,26044,60606,0,0,60606,86650,25359,51403,59.32,2,Largely Rural (rural including hub towns 50-79%) ,Predominantly Rural
E14000777,Leeds Central,486,0,0,132391,132391,132877,0,486,0.36,6,Urban with Major Conurbation,Predominantly Urban
E14000778,Leeds East,0,0,0,94469,94469,94469,0,0,0,6,Urban with Major Conurbation,Predominantly Urban
E14000779,Leeds North East,119,0,0,91521,91521,91640,0,119,0.12,6,Urban with Major Conurbation,Predominantly Urban
E14000780,Leeds North West,6520,1724,0,76327,78051,84571,0,6520,7.7,6,Urban with Major Conurbation,Predominantly Urban
E14000781,Leeds West,272,525,0,92009,92534,92806,0,272,0.29,6,Urban with Major Conurbation,Predominantly Urban
E14000782,Leicester East,0,108520,0,0,108520,108520,0,0,0,4,Urban with City and Town,Predominantly Urban
E14000783,Leicester South,0,119287,0,0,119287,119287,0,0,0,4,Urban with City and Town,Predominantly Urban
E14000784,Leicester West,556,101476,0,0,101476,102032,0,556,0.54,4,Urban with City and Town,Predominantly Urban
E14000785,Leigh,3104,364,0,99529,99893,102997,0,3104,3.01,6,Urban with Major Conurbation,Predominantly Urban
E14000786,Lewes,26908,61284,0,0,61284,88192,17297,44205,50.12,2,Largely Rural (rural including hub towns 50-79%) ,Predominantly Rural
E14000787,Lewisham East,0,0,0,102206,102206,102206,0,0,0,6,Urban with Major Conurbation,Predominantly Urban
E14000788,Lewisham West and Penge,0,0,0,105993,105993,105993,0,0,0,6,Urban with Major Conurbation,Predominantly Urban
E14000789,"Lewisham, Deptford",0,0,0,112827,112827,112827,0,0,0,6,Urban with Major Conurbation,Predominantly Urban
E14000790,Leyton and Wanstead,0,0,0,104183,104183,104183,0,0,0,6,Urban with Major Conurbation,Predominantly Urban
E14000791,Lichfield,30864,34373,0,27748,62121,92985,0,30864,33.19,3,Urban with Significant Rural (rural including hub towns 26-49%),Urban with Significant Rural
E14000792,Lincoln,9121,97213,0,0,97213,106334,0,9121,8.57,4,Urban with City and Town,Predominantly Urban
E14000793,"Liverpool, Riverside",0,0,0,114920,114920,114920,0,0,0,6,Urban with Major Conurbation,Predominantly Urban
E14000794,"Liverpool, Walton",0,0,0,91876,91876,91876,0,0,0,6,Urban with Major Conurbation,Predominantly Urban
E14000795,"Liverpool, Wavertree",0,0,0,91501,91501,91501,0,0,0,6,Urban with Major Conurbation,Predominantly Urban
E14000796,"Liverpool, West Derby",0,0,0,90537,90537,90537,0,0,0,6,Urban with Major Conurbation,Predominantly Urban
E14000797,Loughborough,5456,93721,0,0,93721,99177,0,5456,5.5,4,Urban with City and Town,Predominantly Urban
E14000798,Louth and Horncastle,64551,32334,0,0,32334,96885,32334,96885,100,1,Mainly Rural (rural including hub towns >=80%) ,Predominantly Rural
E14000799,Ludlow,56428,28429,0,0,28429,84857,23172,79600,93.8,1,Mainly Rural (rural including hub towns >=80%) ,Predominantly Rural
E14000800,Luton North,0,98947,0,0,98947,98947,0,0,0,4,Urban with City and Town,Predominantly Urban
E14000801,Luton South,5926,104254,0,0,104254,110180,0,5926,5.37,4,Urban with City and Town,Predominantly Urban
E14000802,Macclesfield,11003,68960,0,13305,82265,93268,0,11003,11.79,4,Urban with City and Town,Predominantly Urban
E14000803,Maidenhead,22637,79133,0,0,79133,101770,182,22819,22.42,4,Urban with City and Town,Predominantly Urban
E14000804,Maidstone and The Weald,31831,68217,0,0,68217,100048,0,31831,31.81,3,Urban with Significant Rural (rural including hub towns 26-49%),Urban with Significant Rural
E14000805,Makerfield,2176,1659,0,94367,96026,98202,0,2176,2.21,6,Urban with Major Conurbation,Predominantly Urban
E14000806,Maldon,42960,45837,0,0,45837,88797,21462,64422,72.54,2,Largely Rural (rural including hub towns 50-79%) ,Predominantly Rural
E14000807,Manchester Central,0,0,0,134326,134326,134326,0,0,0,6,Urban with Major Conurbation,Predominantly Urban
E14000808,"Manchester, Gorton",0,0,0,111198,111198,111198,0,0,0,6,Urban with Major Conurbation,Predominantly Urban
E14000809,"Manchester, Withington",0,0,0,99212,99212,99212,0,0,0,6,Urban with Major Conurbation,Predominantly Urban
E14000810,Mansfield,13703,90763,0,0,90763,104466,0,13703,13.11,4,Urban with City and Town,Predominantly Urban
E14000811,Meon Valley,38067,51796,0,0,51796,89863,0,38067,42.36,3,Urban with Significant Rural (rural including hub towns 26-49%),Urban with Significant Rural
E14000812,Meriden,20398,3570,0,83889,87459,107857,0,20398,18.91,6,Urban with Major Conurbation,Predominantly Urban
E14000813,Mid Bedfordshire,65110,35011,0,0,35011,100121,20026,85136,85.03,1,Mainly Rural (rural including hub towns >=80%) ,Predominantly Rural
E14000814,Mid Derbyshire,2416,81478,264,0,81742,84158,0,2416,2.87,4,Urban with City and Town,Predominantly Urban
E14000815,Mid Dorset and North Poole,15165,65628,0,0,65628,80793,0,15165,18.77,4,Urban with City and Town,Predominantly Urban
E14000816,Mid Norfolk,55053,44787,0,0,44787,99840,44787,99840,100,1,Mainly Rural (rural including hub towns >=80%) ,Predominantly Rural
E14000817,Mid Sussex,14277,91504,0,0,91504,105781,0,14277,13.49,4,Urban with City and Town,Predominantly Urban
E14000818,Mid Worcestershire,44602,49852,0,0,49852,94454,47704,92306,97.72,1,Mainly Rural (rural including hub towns >=80%) ,Predominantly Rural
E14000819,Middlesbrough,0,93865,0,0,93865,93865,0,0,0,4,Urban with City and Town,Predominantly Urban
E14000820,Middlesbrough South and East Cleveland,32257,60569,0,0,60569,92826,0,32257,34.74,3,Urban with Significant Rural (rural including hub towns 26-49%),Urban with Significant Rural
E14000821,Milton Keynes North,18765,103033,0,0,103033,121798,0,18765,15.4,4,Urban with City and Town,Predominantly Urban
E14000822,Milton Keynes South,2888,124135,0,0,124135,127023,0,2888,2.27,4,Urban with City and Town,Predominantly Urban
E14000823,Mitcham and Morden,0,0,0,103298,103298,103298,0,0,0,6,Urban with Major Conurbation,Predominantly Urban
E14000824,Mole Valley,43580,22110,0,29343,51453,95033,17747,61327,64.53,2,Largely Rural (rural including hub towns 50-79%) ,Predominantly Rural
E14000825,Morecambe and Lunesdale,25780,61903,0,0,61903,87683,0,25780,29.4,3,Urban with Significant Rural (rural including hub towns 26-49%),Urban with Significant Rural
E14000826,Morley and Outwood,1258,4104,0,91131,95235,96493,0,1258,1.3,6,Urban with Major Conurbation,Predominantly Urban
E14000827,New Forest East,23036,69310,0,0,69310,92346,1228,24264,26.27,3,Urban with Significant Rural (rural including hub towns 26-49%),Urban with Significant Rural
E14000828,New Forest West,26363,57753,0,0,57753,84116,29302,55665,66.17,2,Largely Rural (rural including hub towns 50-79%) ,Predominantly Rural
E14000829,Newark,55574,43363,0,0,43363,98937,0,55574,56.17,2,Largely Rural (rural including hub towns 50-79%) ,Predominantly Rural
E14000830,Newbury,38830,68661,0,0,68661,107491,403,39233,36.49,3,Urban with Significant Rural (rural including hub towns 26-49%),Urban with Significant Rural
E14000831,Newcastle upon Tyne Central,261,0,0,93432,93432,93693,0,261,0.27,6,Urban with Major Conurbation,Predominantly Urban
E14000832,Newcastle upon Tyne East,0,0,0,95589,95589,95589,0,0,0,6,Urban with Major Conurbation,Predominantly Urban
E14000833,Newcastle upon Tyne North,5472,583,0,84840,85423,90895,0,5472,6.02,6,Urban with Major Conurbation,Predominantly Urban
E14000834,Newcastle-under-Lyme,13820,75125,0,0,75125,88945,0,13820,15.53,4,Urban with City and Town,Predominantly Urban
E14000835,Newton Abbot,20450,65249,0,0,65249,85699,28775,49225,57.43,2,Largely Rural (rural including hub towns 50-79%) ,Predominantly Rural
E14000836,"Normanton, Pontefract and Castleford",3984,103211,0,0,103211,107195,0,3984,3.71,4,Urban with City and Town,Predominantly Urban
E14000837,North Cornwall,72948,14614,0,0,14614,87562,14614,87562,100,1,Mainly Rural (rural including hub towns >=80%) ,Predominantly Rural
E14000838,North Devon,50867,42800,0,0,42800,93667,11184,62051,66.24,2,Largely Rural (rural including hub towns 50-79%) ,Predominantly Rural
E14000839,North Dorset,59499,36332,0,0,36332,95831,36332,95831,100,1,Mainly Rural (rural including hub towns >=80%) ,Predominantly Rural
E14000840,North Durham,16812,30664,0,39407,70071,86883,0,16812,19.35,6,Urban with Major Conurbation,Predominantly Urban
E14000841,North East Bedfordshire,66613,36103,0,0,36103,102716,28208,94821,92.31,1,Mainly Rural (rural including hub towns >=80%) ,Predominantly Rural
E14000842,North East Cambridgeshire,39479,72897,0,0,72897,112376,44094,83573,74.36,2,Largely Rural (rural including hub towns 50-79%) ,Predominantly Rural
E14000843,North East Derbyshire,11078,42479,37399,0,79878,90956,0,11078,12.17,4,Urban with City and Town,Predominantly Urban
E14000844,North East Hampshire,40046,56043,0,0,56043,96089,1991,42037,43.74,3,Urban with Significant Rural (rural including hub towns 26-49%),Urban with Significant Rural
E14000845,North East Hertfordshire,35353,59933,0,0,59933,95286,15781,51134,53.66,2,Largely Rural (rural including hub towns 50-79%) ,Predominantly Rural
E14000846,North East Somerset,36527,50630,0,0,50630,87157,27136,63663,73.04,2,Largely Rural (rural including hub towns 50-79%) ,Predominantly Rural
E14000847,North Herefordshire,71003,14982,0,0,14982,85985,10938,81941,95.29,1,Mainly Rural (rural including hub towns >=80%) ,Predominantly Rural
E14000848,North Norfolk,72182,12463,0,0,12463,84645,12463,84645,100,1,Mainly Rural (rural including hub towns >=80%) ,Predominantly Rural
E14000849,North Shropshire,73752,30516,0,0,30516,104268,30516,104268,100,1,Mainly Rural (rural including hub towns >=80%) ,Predominantly Rural
E14000850,North Somerset,20450,77828,0,0,77828,98278,41545,61995,63.08,2,Largely Rural (rural including hub towns 50-79%) ,Predominantly Rural
E14000851,North Swindon,9163,98174,0,0,98174,107337,0,9163,8.53,4,Urban with City and Town,Predominantly Urban
E14000852,North Thanet,10474,83031,0,0,83031,93505,0,10474,11.2,4,Urban with City and Town,Predominantly Urban
E14000853,North Tyneside,6967,892,0,94183,95075,102042,0,6967,6.82,6,Urban with Major Conurbation,Predominantly Urban
E14000854,North Warwickshire,41892,48142,0,0,48142,90034,10573,52465,58.27,2,Largely Rural (rural including hub towns 50-79%) ,Predominantly Rural
E14000855,North West Cambridgeshire,66525,58536,0,0,58536,125061,806,67331,53.83,2,Largely Rural (rural including hub towns 50-79%) ,Predominantly Rural
E14000856,North West Durham,60350,31769,0,0,31769,92119,29137,89487,97.14,1,Mainly Rural (rural including hub towns >=80%) ,Predominantly Rural
E14000857,North West Hampshire,45268,55718,0,0,55718,100986,13442,58710,58.13,2,Largely Rural (rural including hub towns 50-79%) ,Predominantly Rural
E14000858,North West Leicestershire,41871,51597,0,0,51597,93468,12370,54241,58.03,2,Largely Rural (rural including hub towns 50-79%) ,Predominantly Rural
E14000859,North West Norfolk,49031,46093,0,0,46093,95124,0,49031,51.54,2,Largely Rural (rural including hub towns 50-79%) ,Predominantly Rural
E14000860,North Wiltshire,56076,32490,0,0,32490,88566,28539,84615,95.53,1,Mainly Rural (rural including hub towns >=80%) ,Predominantly Rural
E14000861,Northampton North,0,86192,0,0,86192,86192,0,0,0,4,Urban with City and Town,Predominantly Urban
E14000862,Northampton South,0,93615,0,0,93615,93615,0,0,0,4,Urban with City and Town,Predominantly Urban
E14000863,Norwich North,0,87352,0,0,87352,87352,0,0,0,4,Urban with City and Town,Predominantly Urban
E14000864,Norwich South,0,96670,0,0,96670,96670,0,0,0,4,Urban with City and Town,Predominantly Urban
E14000865,Nottingham East,0,0,99302,0,99302,99302,0,0,0,5,Urban with Minor Conurbation,Predominantly Urban
E14000866,Nottingham North,0,0,97145,0,97145,97145,0,0,0,5,Urban with Minor Conurbation,Predominantly Urban
E14000867,Nottingham South,0,0,109233,0,109233,109233,0,0,0,5,Urban with Minor Conurbation,Predominantly Urban
E14000868,Nuneaton,4534,86552,0,0,86552,91086,0,4534,4.97,4,Urban with City and Town,Predominantly Urban
E14000869,Old Bexley and Sidcup,152,0,0,86016,86016,86168,0,152,0.17,6,Urban with Major Conurbation,Predominantly Urban
E14000870,Oldham East and Saddleworth,2657,7330,0,91614,98944,101601,0,2657,2.61,6,Urban with Major Conurbation,Predominantly Urban
E14000871,Oldham West and Royton,0,0,0,102616,102616,102616,0,0,0,6,Urban with Major Conurbation,Predominantly Urban
E14000872,Orpington,3321,12897,0,72389,85286,88607,0,3321,3.74,6,Urban with Major Conurbation,Predominantly Urban
E14000873,Oxford East,0,120705,0,0,120705,120705,0,0,0,4,Urban with City and Town,Predominantly Urban
E14000874,Oxford West and Abingdon,10396,95589,0,0,95589,105985,15829,26225,24.74,4,Urban with City and Town,Predominantly Urban
E14000875,Pendle,12514,76938,0,0,76938,89452,10435,22949,25.65,4,Urban with City and Town,Predominantly Urban
E14000876,Penistone and Stocksbridge,17007,26385,43829,0,70214,87221,13069,30076,34.48,3,Urban with Significant Rural (rural including hub towns 26-49%),Urban with Significant Rural
E14000877,Penrith and The Border,65317,16563,0,0,16563,81880,15181,80498,98.31,1,Mainly Rural (rural including hub towns >=80%) ,Predominantly Rural
E14000878,Peterborough,9765,105649,0,0,105649,115414,0,9765,8.46,4,Urban with City and Town,Predominantly Urban
E14000879,"Plymouth, Moor View",0,91528,0,0,91528,91528,0,0,0,4,Urban with City and Town,Predominantly Urban
E14000880,"Plymouth, Sutton and Devonport",0,110199,0,0,110199,110199,0,0,0,4,Urban with City and Town,Predominantly Urban
E14000881,Poole,0,95242,0,0,95242,95242,0,0,0,4,Urban with City and Town,Predominantly Urban
E14000882,Poplar and Limehouse,0,0,0,128745,128745,128745,0,0,0,6,Urban with Major Conurbation,Predominantly Urban
E14000883,Portsmouth North,0,97425,0,0,97425,97425,0,0,0,4,Urban with City and Town,Predominantly Urban
E14000884,Portsmouth South,0,107631,0,0,107631,107631,0,0,0,4,Urban with City and Town,Predominantly Urban
E14000885,Preston,0,94780,0,0,94780,94780,0,0,0,4,Urban with City and Town,Predominantly Urban
E14000886,Pudsey,1127,1296,0,86432,87728,88855,0,1127,1.26,6,Urban with Major Conurbation,Predominantly Urban
E14000887,Putney,0,0,0,93396,93396,93396,0,0,0,6,Urban with Major Conurbation,Predominantly Urban
E14000888,Rayleigh and Wickford,3696,93656,0,0,93656,97352,0,3696,3.79,4,Urban with City and Town,Predominantly Urban
E14000889,Reading East,468,108326,0,0,108326,108794,0,468,0.43,4,Urban with City and Town,Predominantly Urban
E14000890,Reading West,3479,97998,0,0,97998,101477,0,3479,3.42,4,Urban with City and Town,Predominantly Urban
E14000891,Redcar,12580,74318,0,0,74318,86898,0,12580,14.47,4,Urban with City and Town,Predominantly Urban
E14000892,Redditch,7758,81919,0,0,81919,89677,0,7758,8.65,4,Urban with City and Town,Predominantly Urban
E14000893,Reigate,6704,70702,0,23427,94129,100833,0,6704,6.64,4,Urban with City and Town,Predominantly Urban
E14000894,Ribble Valley,39549,57380,0,0,57380,96929,14765,54314,56.03,2,Largely Rural (rural including hub towns 50-79%) ,Predominantly Rural
E14000895,Richmond (Yorks),78665,28636,0,0,28636,107301,28636,107301,100,1,Mainly Rural (rural including hub towns >=80%) ,Predominantly Rural
E14000896,Richmond Park,0,2650,0,114196,116846,116846,0,0,0,6,Urban with Major Conurbation,Predominantly Urban
E14000897,Rochdale,991,1941,0,104873,106814,107805,0,991,0.91,6,Urban with Major Conurbation,Predominantly Urban
E14000898,Rochester and Strood,27276,77995,0,0,77995,105271,0,27276,25.91,4,Urban with City and Town,Predominantly Urban
E14000899,Rochford and Southend East,7780,92303,0,0,92303,100083,0,7780,7.77,4,Urban with City and Town,Predominantly Urban
E14000900,Romford,0,688,0,95206,95894,95894,0,0,0,6,Urban with Major Conurbation,Predominantly Urban
E14000901,Romsey and Southampton North,28427,59813,0,0,59813,88240,0,28427,32.21,3,Urban with Significant Rural (rural including hub towns 26-49%),Urban with Significant Rural
E14000902,Rossendale and Darwen,9515,85471,0,1479,86950,96465,0,9515,9.86,4,Urban with City and Town,Predominantly Urban
E14000903,Rother Valley,23860,37450,33298,0,70748,94608,0,23860,25.21,4,Urban with City and Town,Predominantly Urban
E14000904,Rotherham,313,4768,84616,0,89384,89697,0,313,0.34,5,Urban with Minor Conurbation,Predominantly Urban
E14000905,Rugby,14588,81961,0,0,81961,96549,0,14588,15.1,4,Urban with City and Town,Predominantly Urban
E14000906,"Ruislip, Northwood and Pinner",7399,270,0,86047,86317,93716,0,7399,7.89,6,Urban with Major Conurbation,Predominantly Urban
E14000907,Runnymede and Weybridge,2103,10898,0,89310,100208,102311,0,2103,2.05,6,Urban with Major Conurbation,Predominantly Urban
E14000908,Rushcliffe,46666,232,48065,0,48297,94963,0,46666,49.14,3,Urban with Significant Rural (rural including hub towns 26-49%),Urban with Significant Rural
E14000909,Rutland and Melton,57141,43785,0,0,43785,100926,38680,95821,94.94,1,Mainly Rural (rural including hub towns >=80%) ,Predominantly Rural
E14000910,Saffron Walden,81170,20789,0,0,20789,101959,15210,96380,94.52,1,Mainly Rural (rural including hub towns >=80%) ,Predominantly Rural
E14000911,Salford and Eccles,0,0,0,108546,108546,108546,0,0,0,6,Urban with Major Conurbation,Predominantly Urban
E14000912,Salisbury,36634,54864,0,0,54864,91498,10116,46750,51.09,2,Largely Rural (rural including hub towns 50-79%) ,Predominantly Rural
E14000913,Scarborough and Whitby,22437,74962,0,0,74962,97399,13213,35650,36.6,3,Urban with Significant Rural (rural including hub towns 26-49%),Urban with Significant Rural
E14000914,Scunthorpe,12855,76200,0,0,76200,89055,0,12855,14.43,4,Urban with City and Town,Predominantly Urban
E14000915,Sedgefield,57190,26910,0,0,26910,84100,25964,83154,98.87,1,Mainly Rural (rural including hub towns >=80%) ,Predominantly Rural
E14000916,Sefton Central,3979,24697,0,56284,80981,84960,0,3979,4.68,6,Urban with Major Conurbation,Predominantly Urban
E14000917,Selby and Ainsty,69260,26867,0,0,26867,96127,24859,94119,97.91,1,Mainly Rural (rural including hub towns >=80%) ,Predominantly Rural
E14000918,Sevenoaks,35808,37828,0,19795,57623,93431,29506,65314,69.9,2,Largely Rural (rural including hub towns 50-79%) ,Predominantly Rural
E14000919,Sheffield Central,0,0,115284,0,115284,115284,0,0,0,5,Urban with Minor Conurbation,Predominantly Urban
E14000920,Sheffield South East,387,1857,90674,0,92531,92918,0,387,0.41,5,Urban with Minor Conurbation,Predominantly Urban
E14000921,"Sheffield, Brightside and Hillsborough",0,0,107139,0,107139,107139,0,0,0,5,Urban with Minor Conurbation,Predominantly Urban
E14000922,"Sheffield, Hallam",3329,1522,84505,0,86027,89356,0,3329,3.72,5,Urban with Minor Conurbation,Predominantly Urban
E14000923,"Sheffield, Heeley",369,0,93097,0,93097,93466,0,369,0.39,5,Urban with Minor Conurbation,Predominantly Urban
E14000924,Sherwood,53858,5804,34548,0,40352,94210,0,53858,57.16,2,Largely Rural (rural including hub towns 50-79%) ,Predominantly Rural
E14000925,Shipley,15182,6247,0,73747,79994,95176,0,15182,15.95,6,Urban with Major Conurbation,Predominantly Urban
E14000926,Shrewsbury and Atcham,30667,71715,0,0,71715,102382,0,30667,29.95,3,Urban with Significant Rural (rural including hub towns 26-49%),Urban with Significant Rural
E14000927,Sittingbourne and Sheppey,24132,83973,0,0,83973,108105,34618,58750,54.34,2,Largely Rural (rural including hub towns 50-79%) ,Predominantly Rural
E14000928,Skipton and Ripon,60169,38759,0,338,39097,99266,30986,91155,91.82,1,Mainly Rural (rural including hub towns >=80%) ,Predominantly Rural
E14000929,Sleaford and North Hykeham,73800,37256,0,0,37256,111056,17359,91159,82.08,1,Mainly Rural (rural including hub towns >=80%) ,Predominantly Rural
E14000930,Slough,0,134048,0,0,134048,134048,0,0,0,4,Urban with City and Town,Predominantly Urban
E14000931,Solihull,0,0,0,98817,98817,98817,0,0,0,6,Urban with Major Conurbation,Predominantly Urban
E14000932,Somerton and Frome,77030,26203,0,0,26203,103233,26203,103233,100,1,Mainly Rural (rural including hub towns >=80%) ,Predominantly Rural
E14000933,South Basildon and East Thurrock,12395,84143,0,348,84491,96886,0,12395,12.79,4,Urban with City and Town,Predominantly Urban
E14000934,South Cambridgeshire,89307,20500,0,0,20500,109807,0,89307,81.33,1,Mainly Rural (rural including hub towns >=80%) ,Predominantly Rural
E14000935,South Derbyshire,41072,53539,0,0,53539,94611,0,41072,43.41,3,Urban with Significant Rural (rural including hub towns 26-49%),Urban with Significant Rural
E14000936,South Dorset,29601,62398,0,0,62398,91999,10454,40055,43.53,3,Urban with Significant Rural (rural including hub towns 26-49%),Urban with Significant Rural
E14000937,South East Cambridgeshire,69994,44785,0,0,44785,114779,21232,91226,79.47,2,Largely Rural (rural including hub towns 50-79%) ,Predominantly Rural
E14000938,South East Cornwall,72530,15566,0,0,15566,88096,0,72530,82.33,1,Mainly Rural (rural including hub towns >=80%) ,Predominantly Rural
E14000939,South Holland and The Deepings,56937,44647,0,0,44647,101584,13059,69996,68.9,2,Largely Rural (rural including hub towns 50-79%) ,Predominantly Rural
E14000940,South Leicestershire,46019,54576,0,0,54576,100595,509,46528,46.25,3,Urban with Significant Rural (rural including hub towns 26-49%),Urban with Significant Rural
E14000941,South Norfolk,77121,21072,0,0,21072,98193,9829,86950,88.55,1,Mainly Rural (rural including hub towns >=80%) ,Predominantly Rural
E14000942,South Northamptonshire,63954,44608,0,0,44608,108562,13018,76972,70.9,2,Largely Rural (rural including hub towns 50-79%) ,Predominantly Rural
E14000943,South Ribble,28796,68575,0,0,68575,97371,0,28796,29.57,3,Urban with Significant Rural (rural including hub towns 26-49%),Urban with Significant Rural
E14000944,South Shields,168,5102,0,77024,82126,82294,0,168,0.2,6,Urban with Major Conurbation,Predominantly Urban
E14000945,South Staffordshire,28203,1919,0,63533,65452,93655,0,28203,30.11,3,Urban with Significant Rural (rural including hub towns 26-49%),Urban with Significant Rural
E14000946,South Suffolk,64771,26981,0,0,26981,91752,22213,86984,94.8,1,Mainly Rural (rural including hub towns >=80%) ,Predominantly Rural
E14000947,South Swindon,14685,87134,0,0,87134,101819,0,14685,14.42,4,Urban with City and Town,Predominantly Urban
E14000948,South Thanet,15876,80724,0,0,80724,96600,0,15876,16.43,4,Urban with City and Town,Predominantly Urban
E14000949,South West Bedfordshire,11026,91005,0,0,91005,102031,0,11026,10.8,4,Urban with City and Town,Predominantly Urban
E14000950,South West Devon,18498,70327,0,0,70327,88825,11851,30349,34.16,3,Urban with Significant Rural (rural including hub towns 26-49%),Urban with Significant Rural
E14000951,South West Hertfordshire,16188,40872,0,48249,89121,105309,32570,48758,46.29,3,Urban with Significant Rural (rural including hub towns 26-49%),Urban with Significant Rural
E14000952,South West Norfolk,64196,39403,0,0,39403,103599,35717,99913,96.44,1,Mainly Rural (rural including hub towns >=80%) ,Predominantly Rural
E14000953,South West Surrey,28124,75005,0,0,75005,103129,33462,61586,59.71,2,Largely Rural (rural including hub towns 50-79%) ,Predominantly Rural
E14000954,South West Wiltshire,28957,68596,0,0,68596,97553,17490,46447,47.61,3,Urban with Significant Rural (rural including hub towns 26-49%),Urban with Significant Rural
E14000955,"Southampton, Itchen",0,102731,0,0,102731,102731,0,0,0,4,Urban with City and Town,Predominantly Urban
E14000956,"Southampton, Test",0,105955,0,0,105955,105955,0,0,0,4,Urban with City and Town,Predominantly Urban
E14000957,Southend West,0,88884,0,0,88884,88884,0,0,0,4,Urban with City and Town,Predominantly Urban
E14000958,Southport,0,90381,0,0,90381,90381,0,0,0,4,Urban with City and Town,Predominantly Urban
E14000959,Spelthorne,1360,2955,0,91283,94238,95598,0,1360,1.42,6,Urban with Major Conurbation,Predominantly Urban
E14000960,St Albans,1456,92943,0,3264,96207,97663,0,1456,1.49,4,Urban with City and Town,Predominantly Urban
E14000961,St Austell and Newquay,53390,45636,0,0,45636,99026,45636,99026,100,1,Mainly Rural (rural including hub towns >=80%) ,Predominantly Rural
E14000962,St Helens North,8410,6806,0,81302,88108,96518,0,8410,8.71,6,Urban with Major Conurbation,Predominantly Urban
E14000963,St Helens South and Whiston,1445,1533,0,97679,99212,100657,0,1445,1.43,6,Urban with Major Conurbation,Predominantly Urban
E14000964,St Ives,53011,32056,0,0,32056,85067,32056,85067,100,1,Mainly Rural (rural including hub towns >=80%) ,Predominantly Rural
E14000965,Stafford,26038,69217,0,0,69217,95255,0,26038,27.33,3,Urban with Significant Rural (rural including hub towns 26-49%),Urban with Significant Rural
E14000966,Staffordshire Moorlands,24616,52907,0,0,52907,77523,19903,44519,57.42,2,Largely Rural (rural including hub towns 50-79%) ,Predominantly Rural
E14000967,Stalybridge and Hyde,287,2032,0,89421,91453,91740,0,287,0.31,6,Urban with Major Conurbation,Predominantly Urban
E14000968,Stevenage,6302,87890,0,0,87890,94192,0,6302,6.69,4,Urban with City and Town,Predominantly Urban
E14000969,Stockport,0,0,0,85027,85027,85027,0,0,0,6,Urban with Major Conurbation,Predominantly Urban
E14000970,Stockton North,5859,86174,0,0,86174,92033,0,5859,6.36,4,Urban with City and Town,Predominantly Urban
E14000971,Stockton South,1677,97900,0,0,97900,99577,0,1677,1.68,4,Urban with City and Town,Predominantly Urban
E14000972,Stoke-on-Trent Central,0,83104,0,0,83104,83104,0,0,0,4,Urban with City and Town,Predominantly Urban
E14000973,Stoke-on-Trent North,1152,95563,0,0,95563,96715,0,1152,1.19,4,Urban with City and Town,Predominantly Urban
E14000974,Stoke-on-Trent South,0,89539,0,0,89539,89539,0,0,0,4,Urban with City and Town,Predominantly Urban
E14000975,Stone,46043,38206,0,0,38206,84249,27789,73832,87.63,1,Mainly Rural (rural including hub towns >=80%) ,Predominantly Rural
E14000976,Stourbridge,0,0,0,90024,90024,90024,0,0,0,6,Urban with Major Conurbation,Predominantly Urban
E14000977,Stratford-on-Avon,60326,28164,0,0,28164,88490,27830,88156,99.62,1,Mainly Rural (rural including hub towns >=80%) ,Predominantly Rural
E14000978,Streatham,0,0,0,115046,115046,115046,0,0,0,6,Urban with Major Conurbation,Predominantly Urban
E14000979,Stretford and Urmston,0,483,0,98266,98749,98749,0,0,0,6,Urban with Major Conurbation,Predominantly Urban
E14000980,Stroud,22971,76845,0,0,76845,99816,14992,37963,38.03,3,Urban with Significant Rural (rural including hub towns 26-49%),Urban with Significant Rural
E14000981,Suffolk Coastal,51686,47241,0,0,47241,98927,29171,80857,81.73,1,Mainly Rural (rural including hub towns >=80%) ,Predominantly Rural
E14000982,Sunderland Central,0,0,0,99885,99885,99885,0,0,0,6,Urban with Major Conurbation,Predominantly Urban
E14000983,Surrey Heath,14563,87656,0,3405,91061,105624,0,14563,13.78,4,Urban with City and Town,Predominantly Urban
E14000984,Sutton and Cheam,0,0,0,94824,94824,94824,0,0,0,6,Urban with Major Conurbation,Predominantly Urban
E14000985,Sutton Coldfield,553,0,0,94554,94554,95107,0,553,0.58,6,Urban with Major Conurbation,Predominantly Urban
E14000986,Tamworth,9702,83292,0,2340,85632,95334,0,9702,10.17,4,Urban with City and Town,Predominantly Urban
E14000987,Tatton,21729,30362,0,32196,62558,84287,13191,34920,41.42,3,Urban with Significant Rural (rural including hub towns 26-49%),Urban with Significant Rural
E14000988,Taunton Deane,31744,78443,0,0,78443,110187,13822,45566,41.35,3,Urban with Significant Rural (rural including hub towns 26-49%),Urban with Significant Rural
E14000989,Telford,945,89414,0,0,89414,90359,0,945,1.04,4,Urban with City and Town,Predominantly Urban
E14000990,Tewkesbury,19552,78582,0,0,78582,98134,19778,39330,40.07,3,Urban with Significant Rural (rural including hub towns 26-49%),Urban with Significant Rural
E14000991,The Cotswolds,75158,20686,0,0,20686,95844,17153,92311,96.31,1,Mainly Rural (rural including hub towns >=80%) ,Predominantly Rural
E14000992,The Wrekin,24854,66050,0,0,66050,90904,12741,37595,41.35,3,Urban with Significant Rural (rural including hub towns 26-49%),Urban with Significant Rural
E14000993,Thirsk and Malton,85012,11937,0,0,11937,96949,11937,96949,100,1,Mainly Rural (rural including hub towns >=80%) ,Predominantly Rural
E14000994,Thornbury and Yate,28185,54741,0,0,54741,82926,11687,39872,48.08,3,Urban with Significant Rural (rural including hub towns 26-49%),Urban with Significant Rural
E14000995,Thurrock,7986,3237,0,105032,108269,116255,0,7986,6.86,6,Urban with Major Conurbation,Predominantly Urban
E14000996,Tiverton and Honiton,66803,31027,0,0,31027,97830,31027,97830,100,1,Mainly Rural (rural including hub towns >=80%) ,Predominantly Rural
E14000997,Tonbridge and Malling,52828,46147,0,0,46147,98975,0,52828,53.37,2,Largely Rural (rural including hub towns 50-79%) ,Predominantly Rural
E14000998,Tooting,0,0,0,106890,106890,106890,0,0,0,6,Urban with Major Conurbation,Predominantly Urban
E14000999,Torbay,0,97132,0,0,97132,97132,0,0,0,4,Urban with City and Town,Predominantly Urban
E14001000,Torridge and West Devon,56231,40952,0,0,40952,97183,40952,97183,100,1,Mainly Rural (rural including hub towns >=80%) ,Predominantly Rural
E14001001,Totnes,47828,34971,0,0,34971,82799,16693,64521,77.92,2,Largely Rural (rural including hub towns 50-79%) ,Predominantly Rural
E14001002,Tottenham,0,0,0,129237,129237,129237,0,0,0,6,Urban with Major Conurbation,Predominantly Urban
E14001003,Truro and Falmouth,37358,51931,0,0,51931,89289,23041,60399,67.64,2,Largely Rural (rural including hub towns 50-79%) ,Predominantly Rural
E14001004,Tunbridge Wells,36160,68910,0,0,68910,105070,0,36160,34.41,3,Urban with Significant Rural (rural including hub towns 26-49%),Urban with Significant Rural
E14001005,Twickenham,0,0,0,112202,112202,112202,0,0,0,6,Urban with Major Conurbation,Predominantly Urban
E14001006,Tynemouth,1556,874,0,96329,97203,98759,0,1556,1.57,6,Urban with Major Conurbation,Predominantly Urban
E14001007,Uxbridge and South Ruislip,0,0,0,101217,101217,101217,0,0,0,6,Urban with Major Conurbation,Predominantly Urban
E14001008,Vauxhall,0,0,0,114033,114033,114033,0,0,0,6,Urban with Major Conurbation,Predominantly Urban
E14001009,Wakefield,5613,2366,0,87095,89461,95074,0,5613,5.9,6,Urban with Major Conurbation,Predominantly Urban
E14001010,Wallasey,724,0,0,88720,88720,89444,0,724,0.8,6,Urban with Major Conurbation,Predominantly Urban
E14001011,Walsall North,0,0,0,93878,93878,93878,0,0,0,6,Urban with Major Conurbation,Predominantly Urban
E14001012,Walsall South,284,298,0,97889,98187,98471,0,284,0.28,6,Urban with Major Conurbation,Predominantly Urban
E14001013,Walthamstow,0,0,0,111263,111263,111263,0,0,0,6,Urban with Major Conurbation,Predominantly Urban
E14001014,Wansbeck,22853,59047,0,0,59047,81900,42073,64926,79.27,2,Largely Rural (rural including hub towns 50-79%) ,Predominantly Rural
E14001015,Wantage,47459,59130,0,0,59130,106589,56987,104446,97.98,1,Mainly Rural (rural including hub towns >=80%) ,Predominantly Rural
E14001016,Warley,0,0,0,92201,92201,92201,0,0,0,6,Urban with Major Conurbation,Predominantly Urban
E14001017,Warrington North,19998,75215,0,0,75215,95213,0,19998,21,4,Urban with City and Town,Predominantly Urban
E14001018,Warrington South,5166,101849,0,0,101849,107015,0,5166,4.82,4,Urban with City and Town,Predominantly Urban
E14001019,Warwick and Leamington,7958,89182,0,0,89182,97140,0,7958,8.19,4,Urban with City and Town,Predominantly Urban
E14001020,Washington and Sunderland West,0,0,0,88619,88619,88619,0,0,0,6,Urban with Major Conurbation,Predominantly Urban
E14001021,Watford,0,0,0,114035,114035,114035,0,0,0,6,Urban with Major Conurbation,Predominantly Urban
E14001022,Waveney,17661,84813,0,0,84813,102474,13868,31529,30.76,3,Urban with Significant Rural (rural including hub towns 26-49%),Urban with Significant Rural
E14001023,Wealden,38240,63132,0,0,63132,101372,59036,97276,95.95,1,Mainly Rural (rural including hub towns >=80%) ,Predominantly Rural
E14001024,Weaver Vale,28787,59372,0,0,59372,88159,0,28787,32.65,3,Urban with Significant Rural (rural including hub towns 26-49%),Urban with Significant Rural
E14001025,Wellingborough,18874,87285,0,0,87285,106159,0,18874,17.77,4,Urban with City and Town,Predominantly Urban
E14001026,Wells,45652,57667,0,0,57667,103319,57667,103319,100,1,Mainly Rural (rural including hub towns >=80%) ,Predominantly Rural
E14001027,Welwyn Hatfield,7905,97449,0,0,97449,105354,0,7905,7.5,4,Urban with City and Town,Predominantly Urban
E14001028,Wentworth and Dearne,2835,3163,89364,0,92527,95362,0,2835,2.97,5,Urban with Minor Conurbation,Predominantly Urban
E14001029,West Bromwich East,0,0,0,88030,88030,88030,0,0,0,6,Urban with Major Conurbation,Predominantly Urban
E14001030,West Bromwich West,0,0,0,90191,90191,90191,0,0,0,6,Urban with Major Conurbation,Predominantly Urban
E14001031,West Dorset,56916,38544,0,0,38544,95460,32797,89713,93.97,1,Mainly Rural (rural including hub towns >=80%) ,Predominantly Rural
E14001032,West Ham,0,0,0,158142,158142,158142,0,0,0,6,Urban with Major Conurbation,Predominantly Urban
E14001033,West Lancashire,26531,28098,0,40168,68266,94797,0,26531,27.98,3,Urban with Significant Rural (rural including hub towns 26-49%),Urban with Significant Rural
E14001034,West Suffolk,53729,59665,0,0,59665,113394,59665,113394,100,1,Mainly Rural (rural including hub towns >=80%) ,Predominantly Rural
E14001035,West Worcestershire,56133,35525,0,0,35525,91658,0,56133,61.24,2,Largely Rural (rural including hub towns 50-79%) ,Predominantly Rural
E14001036,Westminster North,0,0,0,116771,116771,116771,0,0,0,6,Urban with Major Conurbation,Predominantly Urban
E14001037,Westmorland and Lonsdale,54772,29147,0,0,29147,83919,29147,83919,100,1,Mainly Rural (rural including hub towns >=80%) ,Predominantly Rural
E14001038,Weston-Super-Mare,16788,87500,0,0,87500,104288,0,16788,16.09,4,Urban with City and Town,Predominantly Urban
E14001039,Wigan,6276,3625,0,91977,95602,101878,0,6276,6.16,6,Urban with Major Conurbation,Predominantly Urban
E14001040,Wimbledon,0,0,0,96395,96395,96395,0,0,0,6,Urban with Major Conurbation,Predominantly Urban
E14001041,Winchester,29500,67803,0,0,67803,97303,0,29500,30.31,3,Urban with Significant Rural (rural including hub towns 26-49%),Urban with Significant Rural
E14001042,Windsor,11521,90417,0,389,90806,102327,0,11521,11.25,4,Urban with City and Town,Predominantly Urban
E14001043,Wirral South,1682,995,0,69635,70630,72312,0,1682,2.32,6,Urban with Major Conurbation,Predominantly Urban
E14001044,Wirral West,1132,1476,0,66601,68077,69209,0,1132,1.63,6,Urban with Major Conurbation,Predominantly Urban
E14001045,Witham,50620,37809,0,0,37809,88429,25353,75973,85.91,1,Mainly Rural (rural including hub towns >=80%) ,Predominantly Rural
E14001046,Witney,59312,45467,0,0,45467,104779,45467,104779,100,1,Mainly Rural (rural including hub towns >=80%) ,Predominantly Rural
E14001047,Woking,5105,7000,0,93765,100765,105870,0,5105,4.82,6,Urban with Major Conurbation,Predominantly Urban
E14001048,Wokingham,22402,78712,0,0,78712,101114,0,22402,22.15,4,Urban with City and Town,Predominantly Urban
E14001049,Wolverhampton North East,0,0,0,88737,88737,88737,0,0,0,6,Urban with Major Conurbation,Predominantly Urban
E14001050,Wolverhampton South East,0,0,0,88177,88177,88177,0,0,0,6,Urban with Major Conurbation,Predominantly Urban
E14001051,Wolverhampton South West,0,0,0,84913,84913,84913,0,0,0,6,Urban with Major Conurbation,Predominantly Urban
E14001052,Worcester,129,98639,0,0,98639,98768,0,129,0.13,4,Urban with City and Town,Predominantly Urban
E14001053,Workington,51243,27120,0,0,27120,78363,27120,78363,100,1,Mainly Rural (rural including hub towns >=80%) ,Predominantly Rural
E14001054,Worsley and Eccles South,284,0,0,98540,98540,98824,0,284,0.28,6,Urban with Major Conurbation,Predominantly Urban
E14001055,Worthing West,0,94724,0,0,94724,94724,0,0,0,4,Urban with City and Town,Predominantly Urban
E14001056,Wycombe,8841,99209,0,0,99209,108050,3754,12595,11.65,4,Urban with City and Town,Predominantly Urban
E14001057,Wyre and Preston North,28695,59769,0,0,59769,88464,0,28695,32.43,3,Urban with Significant Rural (rural including hub towns 26-49%),Urban with Significant Rural
E14001058,Wyre Forest,20907,77068,0,0,77068,97975,20292,41199,42.05,3,Urban with Significant Rural (rural including hub towns 26-49%),Urban with Significant Rural
E14001059,Wythenshawe and Sale East,103,0,0,105335,105335,105438,0,103,0.09,6,Urban with Major Conurbation,Predominantly Urban
E14001060,Yeovil,47925,58858,0,0,58858,106783,13074,60999,57.12,2,Largely Rural (rural including hub towns 50-79%) ,Predominantly Rural
E14001061,York Central,0,104359,0,0,104359,104359,0,0,0,4,Urban with City and Town,Predominantly Urban
E14001062,York Outer,32440,61252,0,0,61252,93692,0,32440,34.62,3,Urban with Significant Rural (rural including hub towns 26-49%),Urban with Significant Rural
