"date","geography","geography code","NS-SeC: All categories: NS-SeC; measures: Value","NS-SeC: 1. Higher managerial, administrative and professional occupations; measures: Value","NS-SeC: 1.1 Large employers and higher managerial and administrative occupations; measures: Value","NS-SeC: 1.2 Higher professional occupations; measures: Value","NS-SeC: 2. Lower managerial, administrative and professional occupations; measures: Value","NS-SeC: 3. Intermediate occupations; measures: Value","NS-SeC: 4. Small employers and own account workers; measures: Value","NS-SeC: 5. Lower supervisory and technical occupations; measures: Value","NS-SeC: 6. Semi-routine occupations; measures: Value","NS-SeC: 7. Routine occupations; measures: Value","NS-SeC: 8. Never worked and long-term unemployed; measures: Value","NS-SeC: L14.1 Never worked; measures: Value","NS-SeC: L14.2 Long-term unemployed; measures: Value","NS-SeC: L15 Full-time students; measures: Value"
"2011","Berwick-upon-Tweed","E14000554",28289,1638,470,1168,6701,4562,2514,1410,5973,2929,1132,757,375,1430
"2011","Bishop Auckland","E14000569",32588,1415,430,985,6341,5302,1816,1622,7559,4585,2054,1554,500,1894
"2011","Blaydon","E14000574",33393,1939,518,1421,7521,7161,1324,1374,7176,3319,1465,1018,447,2114
"2011","Blyth Valley","E14000575",31556,1256,361,895,6476,7130,1137,1439,6824,3658,1753,1255,498,1883
"2011","City of Durham","E14000641",36874,2637,468,2169,7738,5649,1335,1308,5469,3583,1553,1166,387,7602
"2011","Darlington","E14000658",33574,1661,420,1241,6902,6769,1383,1445,7319,3746,2281,1620,661,2068
"2011","Easington","E14000677",31032,1038,353,685,5303,5637,1070,1593,7006,4981,2347,1811,536,2057
"2011","Gateshead","E14000709",35057,1934,399,1535,6374,6191,1060,1573,7273,5005,2770,2125,645,2877
"2011","Hartlepool","E14000733",34123,1182,392,790,6309,5902,1238,1444,7853,4607,3126,2292,834,2462
"2011","Hexham","E14000746",28534,2614,571,2043,8100,5000,2455,1126,4679,1960,857,597,260,1743
"2011","Houghton and Sunderland South","E14000754",33206,1287,404,883,5920,7172,1117,1467,7408,4390,2263,1711,552,2182
"2011","Jarrow","E14000765",31466,1404,421,983,6240,6715,1052,1346,6641,3863,2070,1470,600,2135
"2011","Middlesbrough","E14000819",34047,984,258,726,4993,4835,891,1272,7268,4659,4959,4079,880,4186
"2011","Middlesbrough South and East Cleveland","E14000820",34780,1523,404,1119,7482,6262,1497,1517,7679,3941,2526,1889,637,2353
"2011","Newcastle upon Tyne Central","E14000831",33503,2191,324,1867,5301,4328,1009,1091,5547,3700,4478,3872,606,5858
"2011","Newcastle upon Tyne East","E14000832",37604,2941,366,2575,5811,4584,930,999,4794,3350,2384,1900,484,11811
"2011","Newcastle upon Tyne North","E14000833",33775,2631,511,2120,7341,6726,1269,1463,6594,3192,1910,1439,471,2649
"2011","North Durham","E14000840",32923,1593,445,1148,6674,6617,1353,1525,7163,4019,1892,1395,497,2087
"2011","North Tyneside","E14000853",38910,1980,460,1520,7817,8806,1201,1664,8108,4576,2291,1615,676,2467
"2011","North West Durham","E14000856",34484,1839,539,1300,7858,6148,1828,1553,7539,3773,1905,1434,471,2041
"2011","Redcar","E14000891",32910,1059,363,696,6074,5923,1173,1518,7920,4233,2754,2053,701,2256
"2011","Sedgefield","E14000915",31575,1513,480,1033,6570,5811,1511,1483,6750,4210,1852,1382,470,1875
"2011","South Shields","E14000944",30740,1100,295,805,5483,5728,1115,1373,6815,4083,2875,2122,753,2168
"2011","Stockton North","E14000970",33918,1237,354,883,6209,6142,1203,1591,7702,4482,2853,2130,723,2499
"2011","Stockton South","E14000971",37329,2298,613,1685,8891,7743,1519,1473,6841,3332,2096,1525,571,3136
"2011","Sunderland Central","E14000982",37490,1548,382,1166,7205,6938,1325,1358,7104,4615,3029,2358,671,4368
"2011","Tynemouth","E14001006",37153,2876,625,2251,10006,7956,1601,1281,6326,3045,1671,1161,510,2391
"2011","Wansbeck","E14001014",30652,1449,409,1040,6870,5701,1323,1437,6269,3794,2070,1466,604,1739
"2011","Washington and Sunderland West","E14001020",34332,1279,441,838,5863,7097,1102,1624,7582,5047,2505,1795,710,2233
"2011","Altrincham and Sale West","E14000532",35034,4638,911,3727,9957,7254,2120,998,4551,1811,1288,963,325,2417
"2011","Ashton-under-Lyne","E14000537",33705,1428,373,1055,6004,7206,1331,1523,7028,4212,2559,2006,553,2414
"2011","Barrow and Furness","E14000543",32829,1395,318,1077,6915,5863,1913,1602,7504,4201,1645,1209,436,1791
"2011","Birkenhead","E14000559",33322,1506,332,1174,6359,5647,1172,1511,7046,4501,3223,2434,789,2357
"2011","Blackburn","E14000570",36958,1378,340,1038,5641,5726,1507,1343,6672,4439,6786,6122,664,3466
"2011","Blackley and Broughton","E14000571",38212,1410,263,1147,5794,5921,1383,1486,6730,4825,6360,5591,769,4303
"2011","Blackpool North and Cleveleys","E14000572",30363,1160,369,791,6190,6431,2195,1385,6286,3158,1599,1146,453,1959
"2011","Blackpool South","E14000573",29862,951,261,690,5198,5062,2572,1473,6756,3620,2049,1486,563,2181
"2011","Bolton North East","E14000578",34809,1753,462,1291,7012,6398,1570,1420,6736,3825,3292,2705,587,2803
"2011","Bolton South East","E14000579",36407,1310,372,938,5842,6650,1504,1449,7164,4741,4583,3894,689,3164
"2011","Bolton West","E14000580",35294,2622,640,1982,8612,7408,1891,1378,6290,3201,1559,1117,442,2333
"2011","Bootle","E14000581",37191,1448,383,1065,6652,8379,1068,1458,7871,4222,3155,2265,890,2938
"2011","Burnley","E14000609",31986,1204,368,836,6283,5520,1459,1435,6784,3995,3060,2465,595,2246
"2011","Bury North","E14000611",32320,2150,555,1595,7975,6597,1603,1182,5529,2912,2209,1813,396,2163
"2011","Bury South","E14000612",36146,2472,600,1872,8608,7614,1887,1407,6471,3003,2068,1594,474,2616
"2011","Carlisle","E14000620",32294,1430,356,1074,6401,5757,1512,1544,7985,3754,1342,954,388,2569
"2011","Cheadle","E14000627",33330,3487,791,2696,9451,7500,1865,986,4616,1662,1268,978,290,2495
"2011","Chorley","E14000637",35376,2638,695,1943,9009,7311,1939,1443,6475,3078,1324,976,348,2159
"2011","City of Chester","E14000640",35551,3237,613,2624,8778,5904,1697,1429,5818,2833,1327,951,376,4528
"2011","Congleton","E14000646",34232,2865,733,2132,8944,7029,2318,1416,5670,2970,984,676,308,2036
"2011","Copeland","E14000647",29633,1552,422,1130,6432,4871,2020,1657,6470,3780,1423,1059,364,1428
"2011","Crewe and Nantwich","E14000653",39461,2406,605,1801,8263,7038,1892,1888,7963,4776,1857,1299,558,3378
"2011","Denton and Reddish","E14000661",32286,1561,480,1081,6510,7530,1379,1391,6634,3493,1663,1184,479,2125
"2011","Eddisbury","E14000686",31839,2584,665,1919,7744,5967,2649,1325,5301,2965,1239,905,334,2065
"2011","Ellesmere Port and Neston","E14000688",32802,2068,517,1551,7439,6364,1410,1715,6908,3249,1453,1056,397,2196
"2011","Fylde","E14000706",29804,2404,560,1844,7746,6425,2145,1154,5089,2065,900,624,276,1876
"2011","Garston and Halewood","E14000708",36965,2230,522,1708,7699,6872,1233,1531,7503,3955,3001,2300,701,2941
"2011","Halton","E14000725",35414,1531,479,1052,6673,7244,1208,1612,8016,4185,2443,1749,694,2502
"2011","Hazel Grove","E14000738",29035,2135,551,1584,7432,6892,1660,1103,4818,2203,972,709,263,1820
"2011","Heywood and Middleton","E14000747",38818,1983,539,1444,7978,8132,1681,1603,7283,4681,2816,2064,752,2661
"2011","Hyndburn","E14000758",33520,1423,477,946,6746,6015,1715,1537,6851,3710,2961,2496,465,2562
"2011","Knowsley","E14000775",39841,1320,424,896,6520,7883,1062,1641,8780,5219,4229,3312,917,3187
"2011","Lancaster and Fleetwood","E14000776",33721,2101,387,1714,6655,5034,1731,1152,5230,2823,1280,941,339,7715
"2011","Leigh","E14000785",38494,1937,562,1375,8363,7964,1788,1754,7764,4358,1989,1365,624,2577
"2011","Liverpool, Riverside","E14000793",45879,3278,464,2814,7475,5014,1012,1220,5083,3668,4263,3524,739,14866
"2011","Liverpool, Walton","E14000794",34364,1003,303,700,5262,6679,794,1395,7305,5078,3878,3020,858,2970
"2011","Liverpool, Wavertree","E14000795",34695,2133,424,1709,7245,5876,1071,1119,5494,3143,3336,2742,594,5278
"2011","Liverpool, West Derby","E14000796",34263,1359,402,957,6355,6722,981,1333,7027,4170,3366,2563,803,2950
"2011","Macclesfield","E14000802",34747,3395,798,2597,9709,6853,2426,1398,5306,2454,1093,755,338,2113
"2011","Makerfield","E14000805",36646,1588,497,1091,7790,7703,1473,1664,7919,4572,1667,1168,499,2270
"2011","Manchester Central","E14000807",51453,2988,348,2640,7013,6142,1168,1497,6616,4915,5761,4888,873,15353
"2011","Manchester, Gorton","E14000808",40898,1979,290,1689,5752,4950,1219,1038,5047,3608,6769,6056,713,10536
"2011","Manchester, Withington","E14000809",39261,5438,678,4760,9605,5179,1292,926,3666,2376,2828,2364,464,7951
"2011","Morecambe and Lunesdale","E14000825",32401,1607,434,1173,7023,6002,2158,1392,7284,3245,1553,1137,416,2137
"2011","Oldham East and Saddleworth","E14000870",37085,2021,583,1438,7770,6764,1727,1465,6569,4193,3822,3270,552,2754
"2011","Oldham West and Royton","E14000871",36082,1321,401,920,6111,6587,1205,1523,6522,4586,5168,4574,594,3059
"2011","Pendle","E14000875",32405,1476,436,1040,6348,5260,1737,1426,6299,3830,3722,3230,492,2307
"2011","Penrith and The Border","E14000877",30092,1936,456,1480,6987,4998,3604,1381,6018,2703,781,563,218,1684
"2011","Preston","E14000885",34766,1267,274,993,5027,5569,1000,1363,6412,4122,3732,3108,624,6274
"2011","Ribble Valley","E14000894",35948,2739,733,2006,9677,7705,2514,1511,6000,2589,869,633,236,2344
"2011","Rochdale","E14000897",38713,1563,443,1120,7086,6469,1577,1434,6893,4456,5820,5114,706,3415
"2011","Rossendale and Darwen","E14000902",35879,2263,682,1581,8682,6909,2271,1447,6485,3643,1711,1255,456,2468
"2011","Salford and Eccles","E14000911",40307,2459,516,1943,7975,7971,1209,1544,6868,4218,3001,2386,615,5062
"2011","Sefton Central","E14000916",31847,2333,575,1758,8673,7949,1500,994,5032,2007,988,716,272,2371
"2011","South Ribble","E14000943",35615,2426,656,1770,9180,8056,2186,1400,6377,2647,1014,692,322,2329
"2011","Southport","E14000958",33062,1894,508,1386,8274,6146,1974,1380,6818,2858,1402,986,416,2316
"2011","St Helens North","E14000962",36026,1696,497,1199,7589,7004,1268,1566,7705,4462,2359,1771,588,2377
"2011","St Helens South and Whiston","E14000963",37697,1746,500,1246,7904,7475,1232,1649,7774,4573,2676,2024,652,2668
"2011","Stalybridge and Hyde","E14000967",33995,1912,525,1387,7172,7079,1690,1530,6551,3660,2225,1707,518,2176
"2011","Stockport","E14000969",31195,2457,506,1951,7393,6160,1336,1174,5601,2936,1983,1495,488,2155
"2011","Stretford and Urmston","E14000979",36020,2421,595,1826,8155,8009,1390,1193,6203,3070,2745,2272,473,2834
"2011","Tatton","E14000987",30879,3767,816,2951,8493,5938,2354,1019,4465,1960,1093,839,254,1790
"2011","Wallasey","E14001010",33458,1534,461,1073,6890,6581,1379,1607,7090,3696,2316,1680,636,2365
"2011","Warrington North","E14001017",35423,2118,560,1558,7678,7709,1410,1467,7059,3825,1738,1235,503,2419
"2011","Warrington South","E14001018",39291,3762,901,2861,10282,8468,1921,1442,6598,3030,1269,909,360,2519
"2011","Weaver Vale","E14001024",32963,2474,654,1820,7769,6473,1619,1437,6166,3283,1617,1130,487,2125
"2011","West Lancashire","E14001033",35966,2198,531,1667,8194,6579,1793,1424,6314,3750,1646,1138,508,4068
"2011","Westmorland and Lonsdale","E14001037",30988,2181,532,1649,8165,4973,3401,1650,5796,2566,533,357,176,1723
"2011","Wigan","E14001039",37426,1642,489,1153,7593,6772,1524,1711,8043,5337,2294,1604,690,2510
"2011","Wirral South","E14001043",26744,2095,460,1635,7241,5764,1153,1063,4450,2188,992,672,320,1798
"2011","Wirral West","E14001044",25441,2211,466,1745,7060,5303,1366,872,3947,1917,984,731,253,1781
"2011","Workington","E14001053",29030,1286,346,940,5853,4616,1988,1478,7153,3768,1358,977,381,1530
"2011","Worsley and Eccles South","E14001054",36412,2061,556,1505,7569,8013,1437,1441,7166,3759,2469,1801,668,2497
"2011","Wyre and Preston North","E14001057",32573,2730,623,2107,9193,7378,2292,1148,4774,1891,857,678,179,2310
"2011","Wythenshawe and Sale East","E14001059",39194,2687,547,2140,8372,7697,1419,1626,7126,4380,3162,2372,790,2725
"2011","Barnsley Central","E14000541",31781,1251,409,842,6116,5469,1395,1576,7182,4709,2125,1533,592,1958
"2011","Barnsley East","E14000542",33503,1100,372,728,5906,6009,1393,1611,7959,5023,2463,1793,670,2039
"2011","Batley and Spen","E14000548",39051,1912,557,1355,7348,7430,1874,1619,6888,4770,4519,3923,596,2691
"2011","Beverley and Holderness","E14000556",37396,2313,592,1721,9430,7632,2470,1642,6952,3260,1288,854,434,2409
"2011","Bradford East","E14000587",38839,1306,352,954,5408,6162,1386,1248,6296,4587,8767,7907,860,3679
"2011","Bradford South","E14000588",37008,1465,396,1069,6377,7276,1499,1532,7116,4916,4074,3253,821,2753
"2011","Bradford West","E14000589",38602,1304,249,1055,5108,5003,1254,963,4795,3746,10493,9820,673,5936
"2011","Brigg and Goole","E14000596",31939,1525,500,1025,6799,5865,2029,1554,6891,3931,1588,1134,454,1757
"2011","Calder Valley","E14000614",38554,3247,786,2461,10241,7383,2482,1462,6324,3575,1460,978,482,2380
"2011","Cleethorpes","E14000643",34671,1363,438,925,6974,6455,1801,1689,8293,4037,1941,1349,592,2118
"2011","Colne Valley","E14000645",40139,3183,735,2448,10178,7425,2295,1532,6306,3840,2526,2024,502,2854
"2011","Dewsbury","E14000666",39518,2311,600,1711,8109,6904,1967,1528,6441,4495,4449,3875,574,3314
"2011","Don Valley","E14000667",35988,1453,483,970,7013,6448,1838,1716,8279,4686,2367,1766,601,2188
"2011","Doncaster Central","E14000668",37971,1522,458,1064,7277,6387,1649,1773,8506,5280,3066,2391,675,2511
"2011","Doncaster North","E14000669",36443,1195,397,798,6129,6085,1747,1763,8965,5357,2944,2187,757,2258
"2011","East Yorkshire","E14000683",37170,1841,554,1287,8188,6453,3175,1817,7961,4058,1574,1101,473,2103
"2011","Elmet and Rothwell","E14000689",36981,3364,873,2491,9202,8647,2071,1317,6428,2711,1007,715,292,2234
"2011","Great Grimsby","E14000716",32101,828,276,552,4980,4774,1096,1700,8859,4640,2948,1960,988,2276
"2011","Halifax","E14000723",36405,1941,473,1468,7174,7013,1531,1426,6753,4098,3721,3036,685,2748
"2011","Haltemprice and Howden","E14000724",32682,2596,702,1894,8767,7143,2165,1206,5086,2331,908,616,292,2480
"2011","Harrogate and Knaresborough","E14000730",37216,3284,753,2531,10436,7402,2571,1592,6237,2521,932,626,306,2241
"2011","Hemsworth","E14000740",34892,1566,458,1108,6598,6003,1561,1523,7430,5980,2185,1629,556,2046
"2011","Huddersfield","E14000756",34836,1848,453,1395,6562,5419,1475,1334,5972,4072,3523,2914,609,4631
"2011","Keighley","E14000766",34878,2405,592,1813,8102,6244,2123,1319,5754,3407,3075,2620,455,2449
"2011","Kingston upon Hull East","E14000771",33446,867,253,614,4986,5733,1019,1727,8515,5214,3159,2172,987,2226
"2011","Kingston upon Hull North","E14000772",35613,1201,275,926,5709,4778,847,1562,7459,5036,3407,2429,978,5614
"2011","Kingston upon Hull West and Hessle","E14000773",30609,1043,262,781,5041,5187,1047,1590,7057,4761,2726,1960,766,2157
"2011","Leeds Central","E14000777",51109,2351,340,2011,6483,6636,1087,1739,8046,5674,5436,4314,1122,13657
"2011","Leeds East","E14000778",34111,1398,336,1062,5587,6458,1102,1491,7160,4048,4112,3367,745,2755
"2011","Leeds North East","E14000779",34380,4634,720,3914,9308,5795,1694,1005,4287,1993,2665,2188,477,2999
"2011","Leeds North West","E14000780",33965,3060,515,2545,7017,4926,1391,849,3702,1635,1107,857,250,10278
"2011","Leeds West","E14000781",34783,2018,413,1605,6519,6743,1170,1513,6529,4100,2474,1830,644,3717
"2011","Morley and Outwood","E14000826",36646,2656,726,1930,8664,8763,1706,1488,6569,3448,1273,855,418,2079
"2011","Normanton, Pontefract and Castleford","E14000836",40043,1402,440,962,7000,7220,1532,2063,9615,6551,2496,1819,677,2164
"2011","Penistone and Stocksbridge","E14000876",32731,2224,648,1576,8124,7107,1847,1318,6074,3029,1162,851,311,1846
"2011","Pudsey","E14000886",33581,3489,741,2748,8986,7405,1826,1117,5077,2438,1085,765,320,2158
"2011","Richmond (Yorks)","E14000895",38092,2688,785,1903,10140,7220,3315,1709,6462,3401,1268,874,394,1889
"2011","Rother Valley","E14000903",35178,1839,515,1324,7672,7446,1773,1490,7316,3554,1913,1421,492,2175
"2011","Rotherham","E14000904",32608,1026,307,719,5370,5699,1164,1404,7494,4270,3904,3251,653,2277
"2011","Scarborough and Whitby","E14000913",36268,1420,406,1014,7874,5317,3359,1865,8062,4209,1660,1173,487,2502
"2011","Scunthorpe","E14000914",32217,1070,345,725,5541,5403,1329,1722,7915,4595,2468,1840,628,2174
"2011","Selby and Ainsty","E14000917",35987,2908,792,2116,8768,7048,2702,1486,6636,3126,1113,734,379,2200
"2011","Sheffield Central","E14000919",45544,3507,389,3118,7320,4045,1049,986,4487,3020,3305,2854,451,17825
"2011","Sheffield South East","E14000920",33690,1409,364,1045,6014,7048,1280,1484,7280,3711,3044,2527,517,2420
"2011","Sheffield, Brightside and Hillsborough","E14000921",38270,1327,297,1030,5976,6195,1205,1618,8406,5183,5221,4360,861,3139
"2011","Sheffield, Hallam","E14000922",33840,4726,692,4034,9804,5713,1661,750,3220,1344,809,586,223,5813
"2011","Sheffield, Heeley","E14000923",34556,1878,418,1460,7231,6370,1271,1432,7346,3970,2470,1832,638,2588
"2011","Shipley","E14000925",35268,2991,688,2303,9663,7902,2013,1189,5227,2672,1416,1013,403,2195
"2011","Skipton and Ripon","E14000928",36189,2850,711,2139,9791,6676,3721,1503,5933,2844,848,583,265,2023
"2011","Thirsk and Malton","E14000993",35644,2352,592,1760,8503,5910,3961,1698,6983,3406,962,699,263,1869
"2011","Wakefield","E14001009",35148,1850,543,1307,7197,6586,1575,1457,6921,4929,2522,1903,619,2111
"2011","Wentworth and Dearne","E14001028",35183,1233,385,848,6464,7082,1426,1619,8054,4769,2481,1894,587,2055
"2011","York Central","E14001061",40689,3300,526,2774,8532,5747,1595,1725,6955,3821,1436,941,495,7578
"2011","York Outer","E14001062",35603,2926,708,2218,8822,7014,1983,1360,6255,2287,746,524,222,4210
"2011","Amber Valley","E14000533",32795,1534,488,1046,6325,5874,1763,1779,6950,5169,1517,1023,494,1884
"2011","Ashfield","E14000535",37886,1337,464,873,6403,6717,1825,2011,8466,6883,2162,1543,619,2082
"2011","Bassetlaw","E14000546",38134,1668,565,1103,7854,6542,2035,2038,8684,4858,2120,1569,551,2335
"2011","Bolsover","E14000577",34884,1435,478,957,6349,5903,1740,1794,7825,5735,2082,1482,600,2021
"2011","Boston and Skegness","E14000582",37944,1176,373,803,6454,5605,2635,2264,9743,6030,2104,1535,569,1933
"2011","Bosworth","E14000583",36578,2399,728,1671,8376,7779,2338,1690,6432,4262,1171,770,401,2131
"2011","Broxtowe","E14000607",35326,3311,663,2648,8385,7060,1544,1442,5922,3371,1320,893,427,2971
"2011","Charnwood","E14000625",35227,2667,676,1991,8484,7890,2095,1328,5940,3191,1077,730,347,2555
"2011","Chesterfield","E14000632",34594,1727,533,1194,7376,6884,1585,1454,7374,4187,1919,1392,527,2088
"2011","Corby","E14000648",40517,2238,699,1539,8298,7433,2153,2200,7831,6214,1579,1033,546,2571
"2011","Daventry","E14000660",34502,2860,781,2079,8791,7469,2559,1361,5184,3165,907,571,336,2206
"2011","Derby North","E14000662",36990,2205,501,1704,7728,6508,1297,1593,6579,4058,2214,1644,570,4808
"2011","Derby South","E14000663",38594,1585,439,1146,6463,6111,1330,1852,7350,5476,5182,4328,854,3245
"2011","Derbyshire Dales","E14000664",28751,2541,624,1917,7703,5008,2717,1249,4614,2675,683,467,216,1561
"2011","Erewash","E14000695",35052,1813,532,1281,6785,6953,1608,1889,7270,4892,1634,1014,620,2208
"2011","Gainsborough","E14000707",34399,1916,533,1383,8102,6693,2516,1488,6852,3140,1596,1149,447,2096
"2011","Gedling","E14000710",34618,2369,640,1729,8254,7589,1661,1491,6226,3358,1427,971,456,2243
"2011","Grantham and Stamford","E14000714",38833,2440,772,1668,8985,7337,2499,1837,8022,4024,1404,927,477,2285
"2011","Harborough","E14000728",37077,2923,673,2250,8834,7841,2135,1431,5789,3218,1337,940,397,3569
"2011","High Peak","E14000748",33779,2514,599,1915,8421,6098,2254,1486,6140,3288,1196,767,429,2382
"2011","Kettering","E14000769",34229,2096,591,1505,7950,7031,1840,1445,6413,4092,1418,921,497,1944
"2011","Leicester East","E14000782",39562,1344,249,1095,4944,5831,1286,1420,7282,7260,6233,5325,908,3962
"2011","Leicester South","E14000783",44862,2513,359,2154,6007,5368,1196,1216,5581,5375,6061,5283,778,11545
"2011","Leicester West","E14000784",37678,1460,332,1128,5823,5585,1102,1750,7129,5835,4035,3120,915,4959
"2011","Lincoln","E14000792",40958,1839,495,1344,7534,6603,1633,1931,8401,4136,2285,1671,614,6596
"2011","Loughborough","E14000797",36821,2647,507,2140,7438,5939,1675,1472,5533,3771,1657,1263,394,6689
"2011","Louth and Horncastle","E14000798",36086,1379,445,934,7577,6378,3193,1763,8244,3969,1737,1292,445,1846
"2011","Mansfield","E14000810",38807,1438,478,960,7318,6742,1671,2047,8682,6237,2299,1730,569,2373
"2011","Mid Derbyshire","E14000814",31030,2368,633,1735,8270,6734,1649,1260,5287,2695,843,563,280,1924
"2011","Newark","E14000829",36056,2749,750,1999,8903,6602,2566,1646,6703,3221,1399,993,406,2267
"2011","North East Derbyshire","E14000843",33935,1789,521,1268,7617,7121,1951,1532,6973,3690,1385,1008,377,1877
"2011","North West Leicestershire","E14000858",34311,2263,586,1677,7519,6711,2030,1638,6519,4120,1306,853,453,2205
"2011","Northampton North","E14000861",32224,1553,404,1149,6473,6637,1273,1323,5782,3625,1832,1302,530,3726
"2011","Northampton South","E14000862",34579,1884,472,1412,6941,7244,1424,1441,6025,4403,2385,1745,640,2832
"2011","Nottingham East","E14000865",36934,2102,406,1696,6205,4321,1133,1265,5246,4199,4257,3528,729,8206
"2011","Nottingham North","E14000866",35878,1028,317,711,5146,5577,1052,1957,8098,6170,3993,2899,1094,2857
"2011","Nottingham South","E14000867",41158,2493,369,2124,5562,4762,1089,1322,5024,3802,2948,2404,544,14156
"2011","Rushcliffe","E14000908",34969,4638,945,3693,9901,6527,2137,1118,4345,1951,976,680,296,3376
"2011","Rutland and Melton","E14000909",36444,2995,805,2190,9272,6778,3102,1584,6041,3252,951,627,324,2469
"2011","Sherwood","E14000924",35094,1879,570,1309,7332,6900,1847,1636,7216,4655,1595,1124,471,2034
"2011","Sleaford and North Hykeham","E14000929",41363,2519,819,1700,9979,8536,3012,1968,8092,3570,1300,895,405,2387
"2011","South Derbyshire","E14000935",34864,2314,686,1628,8125,6868,2106,1673,6602,3673,1273,893,380,2230
"2011","South Holland and The Deepings","E14000939",37675,1761,569,1192,7275,7018,2670,2235,8549,4733,1546,962,584,1888
"2011","South Leicestershire","E14000940",36985,2726,718,2008,9173,8505,2246,1573,6154,3327,922,599,323,2359
"2011","South Northamptonshire","E14000942",39917,3746,986,2760,10935,9217,2911,1460,5638,2758,928,585,343,2324
"2011","Wellingborough","E14001025",38819,2090,572,1518,7981,8061,1844,1804,7628,5264,1952,1324,628,2195
"2011","Aldridge-Brownhills","E14000531",28219,1407,390,1017,6134,6178,1310,1167,5718,3046,1433,992,441,1826
"2011","Birmingham, Edgbaston","E14000560",36992,3911,507,3404,7713,5441,1176,1186,4754,2874,2984,2343,641,6953
"2011","Birmingham, Erdington","E14000561",35722,1329,328,1001,6394,6101,998,1626,7493,4350,4241,3278,963,3190
"2011","Birmingham, Hall Green","E14000562",39736,2625,415,2210,6924,5190,1284,997,4714,2861,10315,9657,658,4826
"2011","Birmingham, Hodge Hill","E14000563",40021,704,155,549,4144,5324,990,1254,6136,4140,12632,11637,995,4697
"2011","Birmingham, Ladywood","E14000564",44674,2294,271,2023,5400,4498,1013,1193,5314,4055,10216,9085,1131,10691
"2011","Birmingham, Northfield","E14000565",37302,1909,430,1479,7612,7412,1062,1551,7301,3975,3471,2516,955,3009
"2011","Birmingham, Perry Barr","E14000566",38389,1544,359,1185,5975,6384,1192,1307,6150,4187,6423,5636,787,5227
"2011","Birmingham, Selly Oak","E14000567",40337,2724,497,2227,7962,6110,1121,1290,5776,3160,2994,2306,688,9200
"2011","Birmingham, Yardley","E14000568",37601,1369,327,1042,6082,7010,1121,1571,7276,4480,5485,4684,801,3207
"2011","Bromsgrove","E14000605",33906,3071,788,2283,9323,7374,2191,1202,5052,2408,966,667,299,2319
"2011","Burton","E14000610",37191,1939,555,1384,7588,6725,1815,1759,7764,4750,2459,1943,516,2392
"2011","Cannock Chase","E14000618",36321,1461,476,985,7275,7048,1680,1857,8286,4528,1873,1311,562,2313
"2011","Coventry North East","E14000649",39422,1510,353,1157,6554,6910,1274,1686,7180,5566,4873,4024,849,3869
"2011","Coventry North West","E14000650",36907,2025,497,1528,7540,7633,1328,1532,6487,3955,2467,1856,611,3940
"2011","Coventry South","E14000651",38645,2311,455,1856,6957,6285,1374,1326,5330,3472,3064,2483,581,8526
"2011","Dudley North","E14000671",29222,1098,292,806,5399,5821,990,1215,6223,3812,2501,1918,583,2163
"2011","Dudley South","E14000672",29037,1116,352,764,5538,6152,1070,1252,6352,3742,1991,1424,567,1824
"2011","Halesowen and Rowley Regis","E14000722",31981,1549,469,1080,6350,7124,1224,1250,6506,3477,2260,1707,553,2241
"2011","Hereford and South Herefordshire","E14000743",35736,1924,506,1418,8044,6203,2745,1684,7907,3462,1503,1042,461,2264
"2011","Kenilworth and Southam","E14000767",30500,3432,727,2705,8457,6089,2384,1018,4063,1767,628,437,191,2662
"2011","Lichfield","E14000791",34813,2607,723,1884,8950,6927,2112,1493,6073,3302,1185,801,384,2164
"2011","Ludlow","E14000799",31124,1996,511,1485,7592,5489,3419,1389,5691,2890,1038,744,294,1620
"2011","Meriden","E14000812",40051,3155,798,2357,9215,8465,1947,1516,7056,3686,2194,1496,698,2817
"2011","Mid Worcestershire","E14000818",34748,2498,718,1780,8340,7048,2679,1548,6292,3162,1126,760,366,2055
"2011","Newcastle-under-Lyme","E14000834",33046,1898,471,1427,6714,5900,1325,1350,6223,3795,1402,995,407,4439
"2011","North Herefordshire","E14000847",31253,2099,527,1572,7853,5447,3447,1327,5644,2638,1048,752,296,1750
"2011","North Shropshire","E14000849",37730,2081,590,1491,8715,6745,3056,1836,7617,3625,1567,1091,476,2488
"2011","North Warwickshire","E14000854",33511,1694,502,1192,6812,7145,1776,1545,6750,4337,1471,1016,455,1981
"2011","Nuneaton","E14000868",33816,1569,472,1097,7015,6787,1436,1502,6605,4624,1970,1391,579,2308
"2011","Redditch","E14000892",33435,1938,565,1373,6970,6835,1657,1485,7030,3560,1668,1145,523,2292
"2011","Rugby","E14000905",35053,2368,620,1748,8154,6992,1857,1649,6217,4118,1433,1006,427,2265
"2011","Shrewsbury and Atcham","E14000926",37338,2365,513,1852,9558,7176,2313,1618,7218,3265,1295,884,411,2530
"2011","Solihull","E14000931",35743,3329,731,2598,9214,8493,1740,1132,5525,2251,1424,1043,381,2635
"2011","South Staffordshire","E14000945",34938,2249,665,1584,8568,7863,2017,1439,6213,3100,1189,814,375,2300
"2011","Stafford","E14000965",34582,2281,601,1680,8821,7178,1685,1547,6150,3002,1341,952,389,2577
"2011","Staffordshire Moorlands","E14000966",28767,1734,486,1248,6752,5507,2229,1331,5418,3169,877,632,245,1750
"2011","Stoke-on-Trent Central","E14000972",30080,989,264,725,4732,4745,964,1308,6101,4803,2611,2065,546,3827
"2011","Stoke-on-Trent North","E14000973",35219,1103,349,754,5447,6142,1332,1687,7892,6085,2957,2372,585,2574
"2011","Stoke-on-Trent South","E14000974",32883,1220,371,849,5786,5873,1213,1520,7061,5538,2388,1875,513,2284
"2011","Stone","E14000975",31464,2440,649,1791,8331,6185,2299,1339,5239,2747,870,626,244,2014
"2011","Stourbridge","E14000976",32847,1731,468,1263,7145,6888,1520,1271,6500,3499,2120,1566,554,2173
"2011","Stratford-on-Avon","E14000977",32833,3124,789,2335,8710,6384,3013,1329,5127,2375,805,562,243,1966
"2011","Sutton Coldfield","E14000985",34819,3610,858,2752,10221,7881,1834,1103,4519,1997,1221,909,312,2433
"2011","Tamworth","E14000986",35532,1909,546,1363,7195,7522,1796,1636,7303,4248,1631,1077,554,2292
"2011","Telford","E14000989",33246,1497,431,1066,5944,6094,1359,1896,7365,4661,2253,1567,686,2177
"2011","The Wrekin","E14000992",32952,1994,521,1473,7510,6438,1698,1511,5979,3376,1676,1286,390,2770
"2011","Walsall North","E14001011",33999,947,298,649,4995,5561,1042,1600,8198,5298,4031,2952,1079,2327
"2011","Walsall South","E14001012",34722,1376,314,1062,5548,5470,1217,1267,6654,4279,5556,4723,833,3355
"2011","Warley","E14001016",32885,1361,331,1030,5453,5343,990,1266,6122,4335,4853,4091,762,3162
"2011","Warwick and Leamington","E14001019",35806,3872,750,3122,8956,6170,1787,1321,5485,2676,1232,857,375,4307
"2011","West Bromwich East","E14001029",31528,1059,295,764,4959,5707,1003,1288,6680,4674,3641,2851,790,2517
"2011","West Bromwich West","E14001030",32570,943,295,648,4956,5670,929,1397,7536,4916,3830,2951,879,2393
"2011","West Worcestershire","E14001035",33478,2645,635,2010,8948,6121,3082,1240,5546,2519,1048,722,326,2329
"2011","Wolverhampton North East","E14001049",32372,884,251,633,5006,5509,919,1467,7481,4719,3460,2557,903,2927
"2011","Wolverhampton South East","E14001050",31788,857,263,594,4423,4974,941,1388,7400,5276,3951,2944,1007,2578
"2011","Wolverhampton South West","E14001051",30374,1986,442,1544,6962,5251,1276,1095,4783,2890,2899,2315,584,3232
"2011","Worcester","E14001052",36927,2328,551,1777,8766,6840,1584,1474,6889,3518,1752,1263,489,3776
"2011","Wyre Forest","E14001058",36424,1861,557,1304,8078,6831,2198,1620,7628,4440,1768,1220,548,2000
"2011","Basildon and Billericay","E14000544",32938,1929,521,1408,7021,8217,1518,1212,6079,3271,1832,1208,624,1859
"2011","Bedford","E14000552",36795,2229,546,1683,7526,6741,1444,1436,6639,4002,2920,2283,637,3858
"2011","Braintree","E14000590",36012,2116,671,1445,8271,7616,2532,1669,7205,3249,1360,873,487,1994
"2011","Brentwood and Ongar","E14000594",34196,3068,808,2260,8969,8700,2276,1120,4745,2056,1144,779,365,2118
"2011","Broadland","E14000603",35087,2049,537,1512,8055,7538,2851,1651,7297,2856,979,666,313,1811
"2011","Broxbourne","E14000606",36643,2230,676,1554,7698,9185,1932,1470,6631,3160,1816,1214,602,2521
"2011","Bury St Edmunds","E14000613",40990,2652,745,1907,10000,8268,2667,1897,8332,3663,1165,800,365,2346
"2011","Cambridge","E14000617",43815,6414,586,5828,9197,4956,1588,1170,4562,2729,1648,1212,436,11551
"2011","Castle Point","E14000622",32864,1456,462,994,6323,8658,1814,1346,7137,3111,1301,904,397,1718
"2011","Central Suffolk and North Ipswich","E14000624",35963,2410,636,1774,8480,7609,2728,1434,6783,3174,1173,806,367,2172
"2011","Chelmsford","E14000628",39111,3201,735,2466,9912,9091,1788,1456,6457,2948,1411,894,517,2847
"2011","Clacton","E14000642",30797,939,346,593,5456,5864,1957,1554,7998,3491,1966,1401,565,1572
"2011","Colchester","E14000644",40508,2622,625,1997,9027,7504,1656,1686,8104,3302,2017,1390,627,4590
"2011","Epping Forest","E14000693",35497,3198,879,2319,8594,8565,2351,1212,5183,2309,1659,1130,529,2426
"2011","Great Yarmouth","E14000717",35318,1004,310,694,5918,6154,2176,1791,8918,5190,2170,1492,678,1997
"2011","Harlow","E14000729",34047,1791,571,1220,7168,7821,1531,1399,6792,3500,1879,1193,686,2166
"2011","Harwich and North Essex","E14000734",34014,2118,544,1574,7614,6834,2417,1390,6455,2734,1263,872,391,3189
"2011","Hemel Hempstead","E14000739",36180,2675,707,1968,8928,8203,1882,1528,6096,2842,1712,1167,545,2314
"2011","Hertford and Stortford","E14000744",39277,4148,1044,3104,10810,8776,2250,1449,5465,2572,1173,794,379,2634
"2011","Hertsmere","E14000745",36918,3308,784,2524,9199,8334,2624,1151,5134,2171,1676,1170,506,3321
"2011","Hitchin and Harpenden","E14000749",35638,4909,994,3915,10603,7123,2331,1086,4158,1953,1069,666,403,2406
"2011","Huntingdon","E14000757",41255,3408,913,2495,10104,9034,2170,1779,7130,3716,1496,1005,491,2418
"2011","Ipswich","E14000761",39539,2152,496,1656,7949,7506,1416,1821,8855,4409,2529,1763,766,2902
"2011","Luton North","E14000800",35369,1693,413,1280,6678,6906,1255,1347,6004,3594,4586,3862,724,3306
"2011","Luton South","E14000801",38890,1661,385,1276,6364,6668,1413,1461,6044,4333,5666,4990,676,5280
"2011","Maldon","E14000806",32983,2250,652,1598,7843,7960,2478,1202,5940,2482,1074,720,354,1754
"2011","Mid Bedfordshire","E14000813",36684,3303,924,2379,9930,8202,2505,1388,5345,2503,930,601,329,2578
"2011","Mid Norfolk","E14000816",35809,1998,580,1418,7798,7025,2633,1752,7788,3597,1203,819,384,2015
"2011","North East Bedfordshire","E14000841",37936,3393,869,2524,10058,8402,2479,1559,5826,2757,1229,783,446,2233
"2011","North East Cambridgeshire","E14000842",41056,1788,580,1208,7448,7866,2554,2111,9553,5399,2126,1451,675,2211
"2011","North East Hertfordshire","E14000845",34639,3317,864,2453,8757,7424,2237,1344,5538,2689,1129,715,414,2204
"2011","North Norfolk","E14000848",30553,1411,393,1018,6798,5243,3052,1543,7010,2975,1117,802,315,1404
"2011","North West Cambridgeshire","E14000855",46199,3346,989,2357,11099,10596,2560,1925,7905,4223,1876,1249,627,2669
"2011","North West Norfolk","E14000859",35222,1496,384,1112,7162,6330,2451,1824,8214,4167,1645,1197,448,1933
"2011","Norwich North","E14000863",31902,1621,411,1210,6332,6522,1496,1581,7446,3614,1387,953,434,1903
"2011","Norwich South","E14000864",37357,2896,433,2463,7637,5255,1428,1307,6284,3555,1925,1368,557,7070
"2011","Peterborough","E14000878",41326,1797,472,1325,6942,7878,1597,1739,7921,6066,4566,3799,767,2820
"2011","Rayleigh and Wickford","E14000888",35810,2047,649,1398,7988,10773,2009,1330,6265,2591,935,586,349,1872
"2011","Rochford and Southend East","E14000899",36332,1799,484,1315,7348,8113,2004,1535,7081,3358,2479,1729,750,2615
"2011","Saffron Walden","E14000910",37165,3484,849,2635,9874,7881,2927,1366,5521,2567,1031,633,398,2514
"2011","South Basildon and East Thurrock","E14000933",36422,1587,471,1116,7161,8877,1565,1524,7792,3709,1975,1313,662,2232
"2011","South Cambridgeshire","E14000934",40173,5603,994,4609,11321,7837,2639,1242,4924,2401,975,654,321,3231
"2011","South East Cambridgeshire","E14000937",41631,4496,913,3583,10980,8397,2887,1555,6469,3099,1279,878,401,2469
"2011","South Norfolk","E14000941",36248,2733,621,2112,8986,7374,2905,1475,6766,2992,1047,715,332,1970
"2011","South Suffolk","E14000946",33393,2205,631,1574,7940,6786,2646,1579,6250,3137,1000,650,350,1850
"2011","South West Bedfordshire","E14000949",37528,2425,698,1727,8821,8660,1979,1583,6563,3461,1671,1063,608,2365
"2011","South West Hertfordshire","E14000951",38006,4519,1143,3376,10978,8010,2830,1118,4615,2181,1142,779,363,2613
"2011","South West Norfolk","E14000952",37548,1645,573,1072,7261,7068,2612,2149,8417,4806,1584,1116,468,2006
"2011","Southend West","E14000957",32181,2120,564,1556,8022,7860,1858,1139,5477,2390,1482,1040,442,1833
"2011","St Albans","E14000960",35432,5221,1119,4102,10807,6473,2075,1010,4127,1728,1453,1141,312,2538
"2011","Stevenage","E14000968",34506,2369,601,1768,8001,7660,1570,1609,6398,2852,1643,1077,566,2404
"2011","Suffolk Coastal","E14000981",35570,2050,526,1524,8444,7032,3119,1764,6990,3237,1053,752,301,1881
"2011","Thurrock","E14000995",41690,2027,608,1419,8343,9155,1572,1779,8798,4281,3078,2042,1036,2657
"2011","Watford","E14001021",41961,3676,876,2800,10792,8980,2186,1480,6217,2976,2497,1911,586,3157
"2011","Waveney","E14001022",36971,1255,386,869,6795,6720,2159,1914,9507,4757,1859,1294,565,2005
"2011","Welwyn Hatfield","E14001027",39053,3173,748,2425,8571,7528,1846,1371,5636,2639,1505,996,509,6784
"2011","West Suffolk","E14001034",40674,2291,661,1630,8525,8195,2519,2147,8278,4930,1512,1050,462,2277
"2011","Witham","E14001045",32804,2316,641,1675,7537,7570,2051,1370,6188,2806,1152,761,391,1814
"2011","Barking","E14000540",43044,1565,325,1240,7111,7344,1984,1619,7689,4297,6721,5488,1233,4714
"2011","Battersea","E14000549",44351,8450,1564,6886,14886,6112,2397,1120,3520,2216,2470,1833,637,3180
"2011","Beckenham","E14000551",32120,3605,894,2711,9223,8089,1945,862,3721,1414,1136,761,375,2125
"2011","Bermondsey and Old Southwark","E14000553",50607,6750,1113,5637,11274,6471,1924,1654,5366,3344,4537,3476,1061,9287
"2011","Bethnal Green and Bow","E14000555",47551,4497,710,3787,10219,5728,1564,1180,4206,2494,9305,8483,822,8358
"2011","Bexleyheath and Crayford","E14000558",32450,1751,506,1245,6834,8753,1378,1157,5723,2466,1823,1251,572,2565
"2011","Brent Central","E14000591",50836,3072,622,2450,9465,6997,3472,1782,7271,4965,7566,6430,1136,6246
"2011","Brent North","E14000592",47269,3284,563,2721,8234,7506,3073,1485,6923,3876,7011,6209,802,5877
"2011","Brentford and Isleworth","E14000593",48611,5532,1116,4416,12533,7919,3235,1601,5583,3000,4393,3630,763,4815
"2011","Bromley and Chislehurst","E14000604",32788,3486,843,2643,8633,7463,1936,978,4349,1829,1781,1242,539,2333
"2011","Camberwell and Peckham","E14000615",48272,3967,730,3237,11213,6401,2293,1729,6555,3994,5404,4207,1197,6716
"2011","Carshalton and Wallington","E14000621",35809,2688,683,2005,8891,8673,1699,1228,5386,2365,2085,1464,621,2794
"2011","Chelsea and Fulham","E14000629",43422,7658,1601,6057,13644,5498,3321,899,3412,1925,3245,2577,668,3820
"2011","Chingford and Woodford Green","E14000634",32916,2948,705,2243,8318,7311,1861,1031,4120,2088,2500,1973,527,2739
"2011","Chipping Barnet","E14000636",42167,4674,911,3763,11310,8165,3080,1072,4627,2180,3209,2473,736,3850
"2011","Cities of London and Westminster","E14000639",42355,7880,1612,6268,11675,4372,2649,883,3123,1679,3897,3347,550,6197
"2011","Croydon Central","E14000654",43019,3318,748,2570,9858,9436,1885,1468,6467,2994,3722,2761,961,3871
"2011","Croydon North","E14000655",50612,3282,819,2463,11298,9409,2652,1568,7471,3301,5847,4650,1197,5784
"2011","Croydon South","E14000656",41987,4312,1013,3299,11527,10062,2297,1165,4986,1920,2393,1751,642,3325
"2011","Dagenham and Rainham","E14000657",37025,1457,385,1072,6596,8494,1519,1530,7115,3454,3560,2612,948,3300
"2011","Dulwich and West Norwood","E14000673",43020,5837,1077,4760,12774,5940,2399,1280,4372,2725,3533,2582,951,4160
"2011","Ealing Central and Acton","E14000674",45825,6627,1216,5411,12916,6578,3201,1256,4066,2466,4347,3616,731,4368
"2011","Ealing North","E14000675",44408,3069,680,2389,9001,7655,3111,1492,6090,3620,5907,4971,936,4463
"2011","Ealing, Southall","E14000676",35559,2432,508,1924,6713,5012,1664,1179,4939,3468,5822,5201,621,4330
"2011","East Ham","E14000679",50651,2063,356,1707,6920,6467,2492,1523,6689,4053,12403,11246,1157,8041
"2011","Edmonton","E14000687",41428,1794,476,1318,7149,6472,2052,1318,6246,3632,7587,6613,974,5178
"2011","Eltham","E14000690",33674,2608,624,1984,7518,6881,1654,1127,5219,2509,2588,2013,575,3570
"2011","Enfield North","E14000691",38501,2477,658,1819,8333,7343,1803,1218,5632,2994,4817,3883,934,3884
"2011","Enfield, Southgate","E14000692",36836,3895,822,3073,9315,6578,2946,962,3988,2089,3074,2505,569,3989
"2011","Erith and Thamesmead","E14000696",39698,1907,523,1384,7532,7817,1763,1534,6966,3444,4363,3292,1071,4372
"2011","Feltham and Heston","E14000701",45567,2243,462,1781,7755,8678,1955,1971,8090,4380,5926,5106,820,4569
"2011","Finchley and Golders Green","E14000703",45351,5935,992,4943,12201,6776,3845,1067,4292,2360,4102,3405,697,4773
"2011","Greenwich and Woolwich","E14000718",41796,4560,797,3763,9666,5673,1960,1287,5372,2917,4745,3672,1073,5616
"2011","Hackney North and Stoke Newington","E14000720",48324,4801,817,3984,13073,6164,2981,1329,4748,3104,6758,5736,1022,5366
"2011","Hackney South and Shoreditch","E14000721",46286,4357,686,3671,11140,5572,2424,1396,5040,3348,6573,5369,1204,6436
"2011","Hammersmith","E14000726",47972,6522,1151,5371,13611,6198,2637,1390,4677,2981,4499,3613,886,5457
"2011","Hampstead and Kilburn","E14000727",51977,9296,1481,7815,15779,5969,3515,1143,4244,2493,4530,3719,811,5008
"2011","Harrow East","E14000731",38578,3285,614,2671,7596,7558,2648,1048,5122,2553,4692,4048,644,4076
"2011","Harrow West","E14000732",38208,3871,678,3193,8704,7153,2103,958,4749,2117,4554,3876,678,3999
"2011","Hayes and Harlington","E14000737",39335,1848,441,1407,6769,7291,1401,1556,6669,3800,5469,4554,915,4532
"2011","Hendon","E14000741",45943,3948,711,3237,9741,7346,3709,1242,5791,2977,5233,4374,859,5956
"2011","Holborn and St Pancras","E14000750",54288,6908,938,5970,13033,5668,2672,1206,4718,2488,5892,4983,909,11703
"2011","Hornchurch and Upminster","E14000751",37645,2181,579,1602,7987,10460,1809,1225,6613,2731,1886,1238,648,2753
"2011","Hornsey and Wood Green","E14000752",49522,7143,1242,5901,15687,6010,3591,1346,4141,2590,4156,3364,792,4858
"2011","Ilford North","E14000759",37841,3024,674,2350,8364,7890,2188,1121,5164,2373,4026,3275,751,3691
"2011","Ilford South","E14000760",45458,2958,504,2454,8026,7608,2244,1105,5632,2687,9507,8440,1067,5691
"2011","Islington North","E14000763",42113,6106,887,5219,11929,5046,2016,1171,3917,2519,4661,3844,817,4748
"2011","Islington South and Finsbury","E14000764",41728,6650,930,5720,10178,4925,1715,976,3774,2350,4163,3332,831,6997
"2011","Kensington","E14000768",47135,7566,1658,5908,13543,5037,3649,1060,3956,2451,4589,3748,841,5284
"2011","Kingston and Surbiton","E14000770",44982,5010,1043,3967,11542,8302,2570,1178,5274,2207,2624,2131,493,6275
"2011","Lewisham East","E14000787",38607,3415,744,2671,9910,6751,2014,1203,5365,2443,3659,2822,837,3847
"2011","Lewisham West and Penge","E14000788",40438,3936,877,3059,11242,7441,2132,1323,5243,2406,3308,2419,889,3407
"2011","Lewisham, Deptford","E14000789",43882,4049,795,3254,11011,6091,2109,1459,5354,2918,4305,3364,941,6586
"2011","Leyton and Wanstead","E14000790",38641,3242,650,2592,9114,5721,2620,1332,4448,2853,5040,4235,805,4271
"2011","Mitcham and Morden","E14000823",38603,2509,552,1957,8198,7206,2411,1372,5813,3047,4130,3376,754,3917
"2011","Old Bexley and Sidcup","E14000869",31927,2053,556,1497,7585,9340,1531,955,4777,1810,1226,858,368,2650
"2011","Orpington","E14000872",32744,2776,703,2073,8299,8506,1830,1128,4793,1822,1418,995,423,2172
"2011","Poplar and Limehouse","E14000882",46833,6110,1040,5070,9696,6092,1464,1305,4488,2394,9336,8322,1014,5948
"2011","Putney","E14000887",38362,6227,1244,4983,11571,5282,2244,992,3373,1788,2556,2085,471,4329
"2011","Richmond Park","E14000896",43870,7918,1656,6262,14561,6315,3307,845,3270,1524,1967,1510,457,4163
"2011","Romford","E14000900",35940,2192,546,1646,7974,9958,1662,1204,6073,2414,1913,1299,614,2550
"2011","Ruislip, Northwood and Pinner","E14000906",34855,4349,939,3410,9485,7964,2205,883,3813,1497,1905,1463,442,2754
"2011","Streatham","E14000978",45339,5832,1160,4672,13043,6503,2711,1512,4496,3143,3815,2861,954,4284
"2011","Sutton and Cheam","E14000984",35180,3475,847,2628,9421,8466,1944,1095,4708,1845,1775,1301,474,2451
"2011","Tooting","E14000998",42933,6684,1350,5334,13638,5886,2463,1054,3683,2086,3155,2603,552,4284
"2011","Tottenham","E14001002",47981,2613,579,2034,8751,5547,3225,1713,6364,4701,8381,7289,1092,6686
"2011","Twickenham","E14001005",42135,6630,1432,5198,13890,7140,2760,999,3720,1606,1668,1262,406,3722
"2011","Uxbridge and South Ruislip","E14001007",37749,2801,723,2078,8158,8247,1517,1195,5022,2416,2478,1919,559,5915
"2011","Vauxhall","E14001008",44766,5846,1001,4845,12387,5517,1869,1458,4681,3575,3920,2927,993,5513
"2011","Walthamstow","E14001013",40597,2736,642,2094,8709,5919,2827,1392,4941,3388,6458,5621,837,4227
"2011","West Ham","E14001032",57379,2767,513,2254,9585,7411,3398,2201,7545,5305,10307,8965,1342,8860
"2011","Westminster North","E14001036",46031,7082,1330,5752,11571,5041,2645,1098,4184,2475,6828,6013,815,5107
"2011","Wimbledon","E14001040",36974,7129,1272,5857,11779,6380,2278,805,2885,1369,1763,1402,361,2586
"2011","Aldershot","E14000530",38374,2627,728,1899,8578,8202,1752,1833,7139,3647,1893,1356,537,2703
"2011","Arundel and South Downs","E14000534",35818,3281,857,2424,10028,7177,3730,1300,5166,2265,955,668,287,1916
"2011","Ashford","E14000536",41300,2693,742,1951,9476,8240,2733,1966,7865,4007,1778,1272,506,2542
"2011","Aylesbury","E14000538",39372,3221,980,2241,10488,8716,2141,1418,6052,3070,1828,1390,438,2438
"2011","Banbury","E14000539",42856,3243,830,2413,10509,8678,2681,1918,7841,3919,1494,1061,433,2573
"2011","Basingstoke","E14000545",40211,3740,928,2812,9582,9362,1713,1665,7167,3177,1465,921,544,2340
"2011","Beaconsfield","E14000550",36370,4521,1113,3408,10446,7550,2842,1069,4375,2012,1178,858,320,2377
"2011","Bexhill and Battle","E14000557",36149,2260,622,1638,9077,7423,3453,1384,6628,2437,1391,1026,365,2096
"2011","Bognor Regis and Littlehampton","E14000576",36380,1573,536,1037,7542,7140,2353,1864,8354,3800,1523,1020,503,2231
"2011","Bracknell","E14000586",38524,3740,1022,2718,9896,8496,1996,1554,6375,2686,1341,851,490,2440
"2011","Brighton, Kemptown","E14000597",34456,2288,505,1783,7716,5796,2030,1239,5791,2571,1784,1336,448,5241
"2011","Brighton, Pavilion","E14000598",40603,4120,797,3323,10885,5772,2268,1182,4372,1794,1355,953,402,8855
"2011","Buckingham","E14000608",35612,3895,1008,2887,9985,7389,3034,1112,4752,2186,810,514,296,2449
"2011","Canterbury","E14000619",42550,3243,560,2683,9201,6049,2277,1319,5812,2728,1497,1079,418,10424
"2011","Chatham and Aylesford","E14000626",36092,1652,472,1180,7219,7773,1673,1617,7297,4003,2216,1580,636,2642
"2011","Chesham and Amersham","E14000631",33256,4069,1049,3020,9751,6830,2703,963,4029,1729,1077,789,288,2105
"2011","Chichester","E14000633",38553,3240,776,2464,10084,6923,3409,1526,6285,2779,1201,808,393,3106
"2011","Crawley","E14000652",38931,2087,506,1581,8009,9400,1437,1833,8038,3443,2328,1695,633,2356
"2011","Dartford","E14000659",37600,2323,643,1680,8784,9225,1758,1480,6902,2983,1788,1207,581,2357
"2011","Dover","E14000670",35525,1701,497,1204,7584,6541,2151,1753,7994,3566,1957,1359,598,2278
"2011","East Hampshire","E14000680",34881,3106,801,2305,9373,6472,2932,1397,5674,2530,1125,773,352,2272
"2011","East Surrey","E14000681",38584,3551,981,2570,10556,9160,2754,1313,5627,2045,1137,784,353,2441
"2011","East Worthing and Shoreham","E14000682",35426,2236,589,1647,8520,7940,2226,1450,7047,2617,1264,865,399,2126
"2011","Eastbourne","E14000684",38888,2017,523,1494,9511,7509,2344,1712,7828,3016,1662,1123,539,3289
"2011","Eastleigh","E14000685",38754,2927,749,2178,9534,8764,2046,1640,7219,3033,1275,849,426,2316
"2011","Epsom and Ewell","E14000694",38322,4195,1019,3176,10909,8857,2393,1031,4618,1845,1283,946,337,3191
"2011","Esher and Walton","E14000697",39567,5723,1352,4371,11870,7570,3176,1053,4398,1815,1368,1000,368,2594
"2011","Fareham","E14000699",36036,2838,741,2097,9448,8080,2043,1460,6397,2594,964,654,310,2212
"2011","Faversham and Mid Kent","E14000700",34282,2308,624,1684,8238,7135,2313,1455,6173,3232,1472,1044,428,1956
"2011","Folkestone and Hythe","E14000704",40957,2177,617,1560,9049,8114,2797,1883,8270,3773,2183,1563,620,2711
"2011","Gillingham and Rainham","E14000711",36576,1678,478,1200,7243,8203,1649,1491,7376,3573,2048,1437,611,3315
"2011","Gosport","E14000713",35082,1732,581,1151,8002,7238,1741,1817,7196,3788,1346,887,459,2222
"2011","Gravesham","E14000715",36975,1821,514,1307,7318,7549,1792,1581,7584,4115,2624,1958,666,2591
"2011","Guildford","E14000719",39204,4725,863,3862,10303,6698,2331,1116,4627,2112,1150,800,350,6142
"2011","Hastings and Rye","E14000735",40057,1857,511,1346,8800,7523,2907,1755,8477,3554,2528,1849,679,2656
"2011","Havant","E14000736",33383,1852,507,1345,6979,6339,1699,1652,7278,3950,1613,1112,501,2021
"2011","Henley","E14000742",35578,4405,989,3416,10367,6908,3167,1251,4543,2188,813,560,253,1936
"2011","Horsham","E14000753",37743,3329,783,2546,10283,8635,2644,1465,5744,2263,999,633,366,2381
"2011","Hove","E14000755",37417,3949,861,3088,10974,6859,2694,1215,5104,2053,1785,1245,540,2784
"2011","Isle of Wight","E14000762",50403,2402,675,1727,11233,8646,4200,2558,11342,5085,2110,1375,735,2827
"2011","Lewes","E14000786",31908,2655,610,2045,8497,6248,2716,1290,5556,2089,992,646,346,1865
"2011","Maidenhead","E14000803",37184,4982,1176,3806,10559,7570,2617,1238,4502,2036,1526,1158,368,2154
"2011","Maidstone and The Weald","E14000804",36576,2626,656,1970,9284,7868,2323,1466,6011,3118,1380,991,389,2500
"2011","Meon Valley","E14000811",33390,2999,788,2211,8753,7073,2427,1273,5500,2348,932,660,272,2085
"2011","Mid Sussex","E14000817",38559,3369,854,2515,10832,8888,2565,1462,6057,2196,961,632,329,2229
"2011","Milton Keynes North","E14000821",44715,3849,875,2974,10275,9592,2165,1863,7221,4009,2633,1902,731,3108
"2011","Milton Keynes South","E14000822",46632,3939,840,3099,10426,10467,1985,1888,7951,4156,2735,1902,833,3085
"2011","Mole Valley","E14000824",34507,3895,916,2979,10038,7409,3016,1040,4214,1818,1004,730,274,2073
"2011","New Forest East","E14000827",34089,2273,555,1718,8254,7538,2187,1575,6508,2885,1055,706,349,1814
"2011","New Forest West","E14000828",30239,2089,575,1514,7721,6033,2803,1232,5836,2159,815,568,247,1551
"2011","Newbury","E14000830",38955,4022,916,3106,10013,8002,2682,1505,6381,2893,1214,801,413,2243
"2011","North East Hampshire","E14000844",34930,4354,1085,3269,10055,7646,2541,1175,4649,1840,762,477,285,1908
"2011","North Thanet","E14000852",33949,1640,463,1177,7146,6411,2377,1534,7492,3292,1970,1389,581,2087
"2011","North West Hampshire","E14000857",37135,3155,868,2287,9018,8260,2593,1578,6490,2928,1136,769,367,1977
"2011","Oxford East","E14000873",47169,5071,575,4496,9566,5693,1261,1351,5539,3448,2690,2105,585,12550
"2011","Oxford West and Abingdon","E14000874",39452,5596,771,4825,10472,6941,1878,1242,4745,2467,1118,823,295,4993
"2011","Portsmouth North","E14000883",35451,1825,542,1283,7565,7417,1347,1695,7079,4192,1700,1133,567,2631
"2011","Portsmouth South","E14000884",39629,2552,614,1938,7621,5874,1374,1523,5842,3567,2441,1793,648,8835
"2011","Reading East","E14000889",40799,4795,771,4024,9536,6864,1454,1288,5259,2561,2410,1836,574,6632
"2011","Reading West","E14000890",37284,3050,669,2381,8506,8179,1490,1573,6725,3104,2281,1643,638,2376
"2011","Reigate","E14000893",36382,4117,966,3151,10573,8109,2400,1052,4708,1877,1360,975,385,2186
"2011","Rochester and Strood","E14000898",38579,2091,602,1489,8211,8510,1820,1587,7430,3683,2086,1437,649,3161
"2011","Romsey and Southampton North","E14000901",32814,3143,629,2514,7804,5920,2008,1124,4656,2307,1020,758,262,4832
"2011","Runnymede and Weybridge","E14000907",38312,4288,1109,3179,9989,7524,2353,1163,4677,1982,1262,888,374,5074
"2011","Sevenoaks","E14000918",34114,3487,862,2625,9051,7673,2377,1144,4940,2241,1044,727,317,2157
"2011","Sittingbourne and Sheppey","E14000927",39220,1728,561,1167,7312,8488,2282,1874,7809,4779,2558,1883,675,2390
"2011","Slough","E14000930",47730,2841,528,2313,8790,8581,1987,1912,8281,4792,6143,5203,940,4403
"2011","South Thanet","E14000948",35042,1843,453,1390,7538,6166,2429,1504,7402,3583,2269,1633,636,2308
"2011","South West Surrey","E14000953",36980,4585,945,3640,10839,6986,3016,1163,4593,2010,1037,731,306,2751
"2011","Southampton, Itchen","E14000955",38163,2039,468,1571,7183,6921,1474,1690,7934,3704,2166,1541,625,5052
"2011","Southampton, Test","E14000956",39105,2714,424,2290,7686,6123,1228,1524,6664,4097,2738,2177,561,6331
"2011","Spelthorne","E14000959",35253,2881,747,2134,8865,9258,1894,1327,5412,2219,1423,1007,416,1974
"2011","Surrey Heath","E14000983",38521,4016,1077,2939,10716,8889,2445,1375,5394,2225,1197,814,383,2264
"2011","Tonbridge and Malling","E14000997",35689,3266,870,2396,9135,7834,2599,1271,5428,2694,1131,789,342,2331
"2011","Tunbridge Wells","E14001004",37477,3482,800,2682,10500,7553,2739,1323,5711,2557,1151,800,351,2461
"2011","Wantage","E14001015",38432,4346,973,3373,10452,7754,2442,1456,5668,3161,1090,741,349,2063
"2011","Wealden","E14001023",37069,2823,762,2061,9948,7556,3449,1486,6072,2377,1103,785,318,2255
"2011","Winchester","E14001041",36089,4317,782,3535,9941,6223,2232,1149,4542,1935,809,540,269,4941
"2011","Windsor","E14001042",37155,4897,1186,3711,10532,7751,2453,1198,4414,2059,1329,867,462,2522
"2011","Witney","E14001046",38418,3705,887,2818,10495,7568,2891,1667,6102,3011,915,608,307,2064
"2011","Woking","E14001047",38061,4556,1025,3531,10196,7931,2289,1225,5312,2245,1909,1492,417,2398
"2011","Wokingham","E14001048",37062,5047,1073,3974,10509,8365,2089,1109,4486,1859,1101,764,337,2497
"2011","Worthing West","E14001055",33974,2246,641,1605,8356,7876,2166,1369,6669,2254,1294,912,382,1744
"2011","Wycombe","E14001056",39246,3412,813,2599,9286,7481,2211,1379,5787,2703,3130,2655,475,3857
"2011","Bath","E14000547",34274,3410,638,2772,8347,4659,1862,1050,4199,2107,1004,686,318,7636
"2011","Bournemouth East","E14000584",37028,2424,586,1838,8868,7045,2509,1548,6640,2738,1541,1076,465,3715
"2011","Bournemouth West","E14000585",37052,2074,478,1596,7160,6556,2047,1590,6818,3171,1522,1072,450,6114
"2011","Bridgwater and West Somerset","E14000595",39062,1716,473,1243,8184,6858,3415,1842,8773,4474,1604,1141,463,2196
"2011","Bristol East","E14000599",35094,2115,457,1658,7539,7338,1399,1254,6997,3306,2025,1549,476,3121
"2011","Bristol North West","E14000600",36419,3446,597,2849,8498,6133,1499,1196,6552,3121,2096,1600,496,3878
"2011","Bristol South","E14000601",39696,2650,500,2150,8096,7961,1454,1621,8436,4366,2535,1969,566,2577
"2011","Bristol West","E14000602",47965,6781,810,5971,11687,5170,1815,1040,4252,2380,2708,2237,471,12132
"2011","Camborne and Redruth","E14000616",32011,1350,350,1000,6652,5662,2467,1617,6914,3401,1369,1025,344,2579
"2011","Central Devon","E14000623",32893,2536,580,1956,8447,5855,3860,1345,5764,2450,918,654,264,1718
"2011","Cheltenham","E14000630",39259,3471,718,2753,10110,7122,2045,1370,5995,2845,1417,947,470,4884
"2011","Chippenham","E14000635",35214,2662,695,1967,8900,7160,2217,1542,6418,2995,1115,701,414,2205
"2011","Christchurch","E14000638",29564,1820,518,1302,7197,6975,2254,1147,5716,2089,818,548,270,1548
"2011","Devizes","E14000665",33818,2591,827,1764,8450,6504,2712,1494,5920,3043,1099,724,375,2005
"2011","East Devon","E14000678",33872,2401,567,1834,8836,6929,2895,1388,6360,2399,836,590,246,1828
"2011","Exeter","E14000698",41045,2907,480,2427,8209,7163,1552,1549,7076,3158,1380,964,416,8051
"2011","Filton and Bradley Stoke","E14000702",33705,2788,586,2202,8084,8036,1361,1150,5711,2311,1077,727,350,3187
"2011","Forest of Dean","E14000705",31909,1811,499,1312,6974,5985,2608,1559,6312,3172,1284,934,350,2204
"2011","Gloucester","E14000712",41106,1981,529,1452,8660,8872,1606,1785,8779,4109,2325,1704,621,2989
"2011","Kingswood","E14000774",31918,2040,506,1534,7003,8112,1440,1176,6635,2624,936,637,299,1952
"2011","Mid Dorset and North Poole","E14000815",29823,1891,495,1396,7498,7010,1987,1159,5449,2301,719,465,254,1809
"2011","Newton Abbot","E14000835",31430,1787,458,1329,7621,6018,2519,1391,6808,2602,998,687,311,1686
"2011","North Cornwall","E14000837",32351,1320,360,960,7111,5026,3992,1738,6904,3242,1273,906,367,1745
"2011","North Devon","E14000838",34283,1524,394,1130,7778,5724,3680,1750,7247,3662,1122,769,353,1796
"2011","North Dorset","E14000839",34288,2181,618,1563,8466,6688,3351,1510,5997,3295,943,619,324,1857
"2011","North East Somerset","E14000846",31839,2377,521,1856,7840,6571,2288,1164,5888,2573,849,593,256,2289
"2011","North Somerset","E14000850",35814,3401,810,2591,9731,8009,2433,1328,6054,2195,733,485,248,1930
"2011","North Swindon","E14000851",39267,2596,643,1953,8443,9299,1667,1837,7842,3771,1622,1057,565,2190
"2011","North Wiltshire","E14000860",32314,2835,754,2081,8534,6367,2662,1360,5232,2426,926,614,312,1972
"2011","Plymouth, Moor View","E14000879",34241,1107,320,787,5740,6627,1358,1721,8549,4517,2207,1650,557,2415
"2011","Plymouth, Sutton and Devonport","E14000880",41492,2223,465,1758,7818,6478,1731,1649,7309,3768,2305,1692,613,8211
"2011","Poole","E14000881",34177,2461,610,1851,8288,6993,2232,1506,6575,2892,1192,814,378,2038
"2011","Salisbury","E14000912",33586,2879,675,2204,8851,6675,2381,1440,5839,2564,1025,719,306,1932
"2011","Somerton and Frome","E14000932",37944,2418,635,1783,9548,6540,3820,1598,7135,3534,1190,853,337,2161
"2011","South Dorset","E14000936",33125,1562,443,1119,7958,6208,2538,1741,6918,3297,1204,849,355,1699
"2011","South East Cornwall","E14000938",33226,1799,473,1326,7983,5821,3206,1629,6751,2907,1114,792,322,2016
"2011","South Swindon","E14000947",37059,2589,553,2036,8289,7597,1594,1703,6969,3798,2054,1496,558,2466
"2011","South West Devon","E14000950",33195,2113,514,1599,8360,7537,2327,1387,6291,2309,776,529,247,2095
"2011","South West Wiltshire","E14000954",35801,2123,592,1531,8042,7091,2645,1644,7173,3765,1241,818,423,2077
"2011","St Austell and Newquay","E14000961",36497,1448,427,1021,7453,6410,3278,2029,8103,4037,1498,1047,451,2241
"2011","St Ives","E14000964",31643,1416,364,1052,7325,5059,3752,1642,6455,3075,1056,777,279,1863
"2011","Stroud","E14000980",36546,2802,699,2103,9648,6759,2746,1539,6726,3177,998,662,336,2151
"2011","Taunton Deane","E14000988",40343,2511,635,1876,10052,7905,2751,1670,8154,3231,1360,972,388,2709
"2011","Tewkesbury","E14000990",36295,2603,697,1906,9113,8375,2367,1548,6443,2741,990,661,329,2115
"2011","The Cotswolds","E14000991",35272,2935,755,2180,9361,6168,3743,1441,5729,2679,914,632,282,2302
"2011","Thornbury and Yate","E14000994",30468,2234,564,1670,7509,7035,1931,1175,5407,2443,818,590,228,1916
"2011","Tiverton and Honiton","E14000996",35527,2001,539,1462,8152,6688,3747,1635,7258,3187,1062,734,328,1797
"2011","Torbay","E14000999",35627,1519,432,1087,7650,6316,2981,1814,7802,3817,1726,1163,563,2002
"2011","Torridge and West Devon","E14001000",35906,1948,478,1470,8341,5957,4087,1714,7487,3197,1336,908,428,1839
"2011","Totnes","E14001001",30788,1866,498,1368,7589,4927,3564,1424,6011,2683,1080,760,320,1644
"2011","Truro and Falmouth","E14001003",34288,2278,478,1800,8563,5584,2885,1446,6112,2623,1001,693,308,3796
"2011","Wells","E14001026",37574,2171,564,1607,8830,6593,3355,1710,7839,3417,1195,846,349,2464
"2011","West Dorset","E14001031",34644,2247,592,1655,9323,6158,3599,1488,6197,2756,975,689,286,1901
"2011","Weston-Super-Mare","E14001038",38136,2058,542,1516,8259,7276,2404,1843,8906,3352,1594,1133,461,2444
"2011","Yeovil","E14001060",38342,1914,562,1352,8371,7350,2620,1965,8842,4066,1234,832,402,1980
"2011","Ynys Mon","W07000041",25426,1350,329,1021,5754,4230,1844,1272,5462,2303,1450,1009,441,1761
"2011","Delyn","W07000042",25957,1400,384,1016,6025,4782,1328,1308,5498,2802,1108,791,317,1706
"2011","Alyn and Deeside","W07000043",30525,1496,431,1065,6674,6251,1420,1642,6631,3152,1208,842,366,2051
"2011","Wrexham","W07000044",25863,1294,311,983,5695,4617,1068,1346,5423,3078,1318,949,369,2024
"2011","Llanelli","W07000045",29753,1133,268,865,6312,5089,1466,1440,7080,3437,1909,1484,425,1887
"2011","Gower","W07000046",28774,2005,428,1577,7930,6093,1567,1137,4994,2099,1018,788,230,1931
"2011","Swansea West","W07000047",29849,1659,295,1364,5976,4611,963,1036,4636,2381,1855,1537,318,6732
"2011","Swansea East","W07000048",30010,891,192,699,5515,5951,924,1509,7165,3724,2229,1799,430,2102
"2011","Aberavon","W07000049",24566,694,201,493,4559,4367,927,1292,5953,3338,1866,1495,371,1570
"2011","Cardiff Central","W07000050",35011,2591,376,2215,6210,4424,911,922,3804,1854,2049,1702,347,12246
"2011","Cardiff North","W07000051",33344,3545,551,2994,9278,6813,1251,913,4006,1697,1286,992,294,4555
"2011","Rhondda","W07000052",25378,602,194,408,3998,4183,844,1196,6112,4246,2250,1824,426,1947
"2011","Torfaen","W07000053",30016,1127,365,762,5862,5474,1088,1639,7052,3827,1916,1419,497,2031
"2011","Monmouth","W07000054",30404,2517,556,1961,8302,5198,2385,1248,5260,2441,1107,799,308,1946
"2011","Newport East","W07000055",28466,1223,343,880,5459,5560,1088,1294,5905,3244,2262,1734,528,2431
"2011","Newport West","W07000056",31316,1945,491,1454,7176,6149,1269,1294,5662,2872,2273,1777,496,2676
"2011","Arfon","W07000057",22755,1218,231,987,4919,3115,1087,888,4031,1861,1121,877,244,4515
"2011","Aberconwy","W07000058",20594,1119,277,842,4934,3108,1759,1076,4419,1930,828,588,240,1421
"2011","Clwyd West","W07000059",26461,1367,392,975,6683,4484,2061,1193,5402,2320,1176,849,327,1775
"2011","Vale of Clwyd","W07000060",26186,1033,291,742,5937,4578,1596,1217,5657,2690,1517,1136,381,1961
"2011","Dwyfor Meirionnydd","W07000061",21684,979,242,737,5029,3091,2426,1072,4744,2158,892,700,192,1293
"2011","Clwyd South","W07000062",26097,1207,334,873,5811,4547,1539,1362,5565,3007,1280,925,355,1779
"2011","Montgomeryshire","W07000063",22877,1147,286,861,5282,3611,2492,1131,4931,2160,792,581,211,1331
"2011","Ceredigion","W07000064",28473,1750,291,1459,6160,3713,2922,1066,4533,1851,957,706,251,5521
"2011","Preseli Pembrokeshire","W07000065",28018,1201,270,931,6213,4226,2803,1363,6261,2789,1443,1090,353,1719
"2011","Carmarthen West and South Pembrokeshire","W07000066",28437,1266,302,964,6298,4366,2712,1402,6145,2591,1448,1129,319,2209
"2011","Carmarthen East and Dinefwr","W07000067",26083,1320,303,1017,6219,4402,2663,1125,5299,2267,1193,913,280,1595
"2011","Brecon and Radnorshire","W07000068",25204,1357,351,1006,6312,4124,2868,1149,4640,2253,992,714,278,1509
"2011","Neath","W07000069",27372,998,292,706,5783,5376,1125,1269,6126,3271,1666,1326,340,1758
"2011","Cynon Valley","W07000070",25647,774,259,515,4736,4115,938,1267,6213,3601,2094,1653,441,1909
"2011","Merthyr Tydfil and Rhymney","W07000071",28071,866,258,608,4898,4484,943,1331,6636,4375,2438,1820,618,2100
"2011","Blaenau Gwent","W07000072",26036,646,232,414,4430,3850,848,1440,6613,4022,2432,1810,622,1755
"2011","Bridgend","W07000073",29224,1564,391,1173,7206,5313,1348,1410,6063,2861,1536,1142,394,1923
"2011","Ogmore","W07000074",28211,1050,352,698,5398,4484,1117,1497,6769,4346,1785,1348,437,1765
"2011","Pontypridd","W07000075",30180,1757,440,1317,7050,5650,1127,1275,5540,3027,1521,1150,371,3233
"2011","Caerphilly","W07000076",32414,1480,383,1097,6557,6844,1217,1460,6434,3864,2275,1696,579,2283
"2011","Islwyn","W07000077",27940,1070,383,687,5294,5135,1032,1520,6515,3817,1635,1178,457,1922
"2011","Vale of Glamorgan","W07000078",36238,2385,575,1810,8812,7136,1926,1523,7173,2860,1863,1291,572,2560
"2011","Cardiff West","W07000079",33926,3071,496,2575,8142,5834,1313,1254,5891,2884,2858,2389,469,2679
"2011","Cardiff South and Penarth","W07000080",39541,3037,526,2511,9021,6868,1391,1517,7209,3589,3726,3084,642,3183
"2011","Aberdeen North","S14000001",39546,2364,274,2090,6895,6036,943,1726,6761,4672,1597,1105,492,8552
"2011","Aberdeen South","S14000002",35945,3912,531,3381,9105,6600,1303,1365,5404,2620,1173,853,320,4463
"2011","Airdrie and Shotts","S14000003",32864,1108,232,876,6378,6773,981,1517,7277,4367,2225,1533,692,2238
"2011","Angus","S14000004",32086,1256,282,974,7356,5369,1887,1659,6749,4073,1582,1072,510,2155
"2011","Argyll and Bute","S14000005",32863,1769,414,1355,8248,5614,2868,1691,6597,3071,1185,752,433,1820
"2011","Ayr, Carrick and Cumnock","S14000006",35660,1377,313,1064,7801,5915,1808,1854,7998,4348,2035,1416,619,2524
"2011","Banff and Buchan","S14000007",34033,1224,268,956,6334,5393,2283,1734,8497,5045,1318,923,395,2205
"2011","Berwickshire, Roxburgh and Selkirk","S14000008",35700,1742,391,1351,8161,5827,2824,1624,7514,4351,1323,871,452,2334
"2011","Caithness, Sutherland and Easter Ross","S14000009",23166,905,178,727,4889,3815,1723,1317,5612,2617,1121,778,343,1167
"2011","Central Ayrshire","S14000010",34185,1460,306,1154,7711,6298,1503,1771,7343,3664,1884,1210,674,2551
"2011","Coatbridge, Chryston and Bellshill","S14000011",36716,1701,358,1343,7449,7688,1037,1669,7979,4464,2059,1382,677,2670
"2011","Cumbernauld, Kilsyth and Kirkintilloch East","S14000012",33631,1606,315,1291,7661,7537,1096,1493,6872,3225,1489,955,534,2652
"2011","Dumfries and Galloway","S14000013",36553,1456,288,1168,8063,6080,2807,1830,8557,4015,1769,1207,562,1976
"2011","Dumfriesshire, Clydesdale and Tweeddale","S14000014",32222,1756,363,1393,7494,5252,2383,1705,7378,3296,1186,799,387,1772
"2011","Dundee East","S14000015",33327,1838,318,1520,8219,6422,1264,1359,6189,3422,1687,1176,511,2927
"2011","Dundee West","S14000016",35368,1865,222,1643,6807,5500,860,1364,5665,3869,2095,1519,576,7343
"2011","Dunfermline and West Fife","S14000017",37337,2057,440,1617,8846,8085,1599,1687,7384,3609,1676,1071,605,2394
"2011","East Dunbartonshire","S14000018",30941,3355,481,2874,9788,6824,1251,824,4008,1329,790,534,256,2772
"2011","East Kilbride, Strathaven and Lesmahagow","S14000019",38131,2100,429,1671,9264,8594,1470,1631,7295,3398,1366,843,523,3013
"2011","East Lothian","S14000020",37725,2383,432,1951,9142,7555,2064,1546,7420,3333,1327,869,458,2955
"2011","East Renfrewshire","S14000021",33710,3358,542,2816,9827,7037,1508,978,4898,1649,1299,982,317,3156
"2011","Edinburgh East","S14000022",39294,2859,336,2523,7873,5888,1263,1298,5308,3179,1956,1499,457,9670
"2011","Edinburgh North and Leith","S14000023",42930,6239,742,5497,11623,6483,1850,1525,5114,3022,1915,1417,498,5159
"2011","Edinburgh South","S14000024",33743,4651,515,4136,8572,4891,1341,878,3627,1804,1318,1003,315,6661
"2011","Edinburgh South West","S14000025",38113,3939,521,3418,8970,7021,1197,1273,5556,2914,1720,1280,440,5523
"2011","Edinburgh West","S14000026",33625,3680,596,3084,8807,7465,1467,1120,4874,2513,1264,931,333,2435
"2011","Falkirk","S14000028",41437,2063,421,1642,9473,8575,1612,1826,8585,4766,1913,1288,625,2624
"2011","Glasgow Central","S14000029",35588,2651,271,2380,5948,4107,806,1130,4546,3501,3714,3142,572,9185
"2011","Glasgow East","S14000030",34420,1007,219,788,5360,5891,722,1705,8075,5582,3384,2556,828,2694
"2011","Glasgow North","S14000031",30645,3454,318,3136,6513,3407,736,855,3449,2180,1890,1462,428,8161
"2011","Glasgow North East","S14000032",33365,1206,190,1016,4931,5177,612,1488,7179,5564,3930,3110,820,3278
"2011","Glasgow North West","S14000033",33452,2760,349,2411,7509,5562,794,1267,5603,3528,2857,2167,690,3572
"2011","Glasgow South","S14000034",34618,3203,442,2761,8559,6281,955,1133,5704,3143,2826,2237,589,2814
"2011","Glasgow South West","S14000035",32587,1097,223,874,5521,6059,640,1466,7471,4346,3201,2491,710,2786
"2011","Glenrothes","S14000036",34170,904,244,660,6303,5808,1252,1913,8820,4550,2293,1557,736,2327
"2011","Gordon","S14000037",37740,2642,486,2156,9801,8292,2100,1674,7209,2844,777,548,229,2401
"2011","Inverclyde","S14000038",31491,1367,255,1112,6446,5929,832,1381,6919,4239,1771,1295,476,2607
"2011","Inverness, Nairn, Badenoch and Strathspey","S14000039",38517,2293,411,1882,9707,6959,2399,2225,8177,3377,1248,814,434,2132
"2011","Kilmarnock and Loudoun","S14000040",37207,1548,311,1237,7964,6836,1716,1701,7667,4739,2254,1528,726,2782
"2011","Kirkcaldy and Cowdenbeath","S14000041",36449,1584,355,1229,7827,6800,1470,1776,8122,4285,2137,1392,745,2448
"2011","Lanark and Hamilton East","S14000042",37735,2207,430,1777,9063,7526,1577,1600,7392,3928,1854,1270,584,2588
"2011","Linlithgow and East Falkirk","S14000043",42467,2353,466,1887,9027,8909,1669,1976,8848,5125,2011,1279,732,2549
"2011","Livingston","S14000044",41774,2235,478,1757,8298,9198,1537,2056,8664,5010,1875,1203,672,2901
"2011","Midlothian","S14000045",31752,1768,325,1443,6690,7202,1317,1375,6656,3437,1317,899,418,1990
"2011","Moray","S14000046",34395,1290,334,956,7294,5820,2169,1919,8331,4228,1233,816,417,2111
"2011","Motherwell and Wishaw","S14000047",34878,1282,288,994,7395,7157,1013,1522,7391,4354,2390,1659,731,2374
"2011","Na h-Eileanan An Iar","S14000027",9988,413,86,327,2580,1708,559,492,2336,1050,286,174,112,564
"2011","North Ayrshire and Arran","S14000048",36691,1512,324,1188,7830,6676,1853,1880,7748,4164,2336,1461,875,2692
"2011","North East Fife","S14000049",31538,2303,339,1964,7430,4651,1770,1251,4808,2319,847,552,295,6159
"2011","Ochil and South Perthshire","S14000050",37891,2304,443,1861,9508,6740,2231,1821,7193,3917,1585,1050,535,2592
"2011","Orkney and Shetland","S14000051",16284,746,169,577,3720,2516,1396,1011,4142,1620,361,248,113,772
"2011","Paisley and Renfrewshire North","S14000052",34157,1993,403,1590,8080,7814,955,1466,6322,3258,1531,1082,449,2738
"2011","Paisley and Renfrewshire South","S14000053",33372,1687,371,1316,7609,6999,918,1486,6311,3691,1834,1280,554,2837
"2011","Perth and North Perthshire","S14000054",36412,2316,370,1946,9293,6689,2386,1854,7111,3520,1212,853,359,2031
"2011","Ross, Skye and Lochaber","S14000055",25488,1277,226,1051,6420,4038,2393,1428,5508,2391,763,472,291,1270
"2011","Rutherglen and Hamilton West","S14000056",40169,2195,441,1754,8812,8262,1248,1799,8403,4486,2253,1553,700,2711
"2011","Stirling","S14000057",34991,2743,448,2295,8519,5389,2042,1362,5676,3023,1483,1042,441,4754
"2011","West Aberdeenshire and Kincardine","S14000058",34114,2777,490,2287,9316,7009,2296,1392,5921,2398,707,455,252,2298
"2011","West Dunbartonshire","S14000059",35373,1222,300,922,7159,7516,924,1711,7977,4018,2235,1534,701,2611
"2011","Belfast East","N06000001",34561,2563,437,2126,8039,6787,1054,1284,6631,3712,1901,1479,422,2590
"2011","Belfast North","N06000002",38092,1605,339,1266,6511,6773,900,1558,8321,5391,3787,3092,695,3246
"2011","Belfast South","N06000003",43746,5010,546,4464,10632,6657,1180,1358,5334,3010,2206,1727,479,8359
"2011","Belfast West","N06000004",35489,1007,226,781,5154,6315,602,1331,7102,5467,4702,4007,695,3809
"2011","East Antrim","N06000005",33647,1800,370,1430,7359,6752,1485,1466,6612,3143,1640,1198,442,3390
"2011","East Londonderry","N06000006",36675,1629,273,1356,7365,5804,1854,1584,7220,4003,2915,2278,637,4301
"2011","Fermanagh & South Tyrone","N06000007",36335,1624,301,1323,7340,5665,2172,1654,7870,3869,2904,2389,515,3237
"2011","Foyle","N06000008",37804,1518,297,1221,6934,5481,1104,1557,7332,5101,4220,3241,979,4557
"2011","Lagan Valley","N06000009",37175,2634,487,2147,9235,7477,1807,1404,7021,3164,1468,1096,372,2965
"2011","Mid Ulster","N06000010",35136,1484,287,1197,7413,5282,1763,1401,6821,4186,2922,2392,530,3864
"2011","Newry & Armagh","N06000011",40162,1783,341,1442,8310,6682,1924,1767,7593,4688,3538,2841,697,3877
"2011","North Antrim","N06000012",39298,1692,353,1339,8356,6653,2121,1649,8812,4362,2443,1834,609,3210
"2011","North Down","N06000013",33716,2310,484,1826,8891,7013,1732,1298,6313,2345,1376,955,421,2438
"2011","South Antrim","N06000014",36696,2098,503,1595,8709,7691,1568,1484,6897,3619,1616,1246,370,3014
"2011","South Down","N06000015",38559,1973,369,1604,8861,6453,2192,1593,7434,3743,2585,2087,498,3725
"2011","Strangford","N06000016",33326,1743,372,1371,7645,7105,1840,1370,6495,3080,1414,1053,361,2634
"2011","Upper Bann","N06000017",43085,2028,469,1559,8907,7640,1736,2076,9098,5304,2636,1988,648,3660
"2011","West Tyrone","N06000018",32549,1285,222,1063,6526,4784,1592,1314,6322,4078,3399,2794,605,3249
