"date","geography","geography code","NS-SeC: All categories: NS-SeC; measures: Value","NS-SeC: 1. Higher managerial, administrative and professional occupations; measures: Value","NS-SeC: 1.1 Large employers and higher managerial and administrative occupations; measures: Value","NS-SeC: 1.2 Higher professional occupations; measures: Value","NS-SeC: 2. Lower managerial, administrative and professional occupations; measures: Value","NS-SeC: 3. Intermediate occupations; measures: Value","NS-SeC: 4. Small employers and own account workers; measures: Value","NS-SeC: 5. Lower supervisory and technical occupations; measures: Value","NS-SeC: 6. Semi-routine occupations; measures: Value","NS-SeC: 7. Routine occupations; measures: Value","NS-SeC: 8. Never worked and long-term unemployed; measures: Value","NS-SeC: L14.1 Never worked; measures: Value","NS-SeC: L14.2 Long-term unemployed; measures: Value","NS-SeC: L15 Full-time students; measures: Value"
"2011","Berwick-upon-Tweed","E14000554",27987,3288,936,2352,5099,1709,4806,3214,3378,4093,1145,669,476,1255
"2011","Bishop Auckland","E14000569",31834,2793,884,1909,4888,1759,4208,3945,4244,6328,1958,1280,678,1711
"2011","Blaydon","E14000574",31530,3553,883,2670,6053,2493,3277,3915,3961,5138,1368,781,587,1772
"2011","Blyth Valley","E14000575",29625,2785,742,2043,5348,2737,2779,3852,3755,5183,1545,825,720,1641
"2011","City of Durham","E14000641",37022,4715,960,3755,6134,2363,2884,3281,3454,5091,1547,975,572,7553
"2011","Darlington","E14000658",32616,3399,817,2582,5780,2785,3194,3669,4198,5715,1955,1100,855,1921
"2011","Easington","E14000677",30024,1880,563,1317,3937,2143,2571,4192,4339,7016,2015,1289,726,1931
"2011","Gateshead","E14000709",35413,3164,604,2560,5518,2694,2770,4005,5026,6572,2692,1651,1041,2972
"2011","Hartlepool","E14000733",32681,2450,662,1788,4964,2087,3080,4512,4128,6425,2793,1538,1255,2242
"2011","Hexham","E14000746",27285,5176,1217,3959,5888,1450,4797,2621,2367,2685,742,423,319,1559
"2011","Houghton and Sunderland South","E14000754",31085,2280,610,1670,4713,2538,3173,4063,4166,6249,1944,1159,785,1959
"2011","Jarrow","E14000765",29665,2735,646,2089,4802,2410,2589,3866,4010,5724,1687,905,782,1842
"2011","Middlesbrough","E14000819",34204,1783,348,1435,3955,2066,2864,3709,4722,6377,3649,2214,1435,5079
"2011","Middlesbrough South and East Cleveland","E14000820",33070,3480,866,2614,5772,2112,3260,5019,3755,5458,2141,1125,1016,2073
"2011","Newcastle upon Tyne Central","E14000831",35763,3594,448,3146,4530,2127,3209,2923,3953,5010,3037,2006,1031,7380
"2011","Newcastle upon Tyne East","E14000832",40165,4292,586,3706,5390,2501,2425,2592,3445,4460,2436,1522,914,12624
"2011","Newcastle upon Tyne North","E14000833",32054,4401,800,3601,5913,2570,3301,3378,3649,4572,1566,953,613,2704
"2011","North Durham","E14000840",31780,3085,888,2197,5405,2441,3122,3980,4178,5976,1718,975,743,1875
"2011","North Tyneside","E14000853",37085,3421,713,2708,6432,3658,3352,4604,4982,6306,2194,1087,1107,2136
"2011","North West Durham","E14000856",33756,3360,979,2381,6017,2216,4240,3998,4349,6145,1630,953,677,1801
"2011","Redcar","E14000891",30717,2291,642,1649,4668,1947,2516,5124,3778,6021,2309,1216,1093,2063
"2011","Sedgefield","E14000915",30349,3107,916,2191,5236,1942,3262,3844,4008,5800,1465,901,564,1685
"2011","South Shields","E14000944",29796,2373,580,1793,4519,2197,2616,3895,3968,5827,2116,1187,929,2285
"2011","Stockton North","E14000970",33194,2551,644,1907,5101,2165,2945,4437,4250,6405,2788,1543,1245,2552
"2011","Stockton South","E14000971",36213,4883,1198,3685,7590,2779,3452,4434,3602,4715,1724,918,806,3034
"2011","Sunderland Central","E14000982",37576,2832,629,2203,5720,2981,3374,4081,4629,6508,2843,1747,1096,4608
"2011","Tynemouth","E14001006",34741,5382,1088,4294,7645,3169,3577,3466,3679,4112,1504,832,672,2207
"2011","Wansbeck","E14001014",29296,2924,776,2148,5218,2412,2873,3696,3599,5063,1854,1078,776,1657
"2011","Washington and Sunderland West","E14001020",31863,2396,708,1688,4640,2539,2900,4043,4731,6638,1987,1123,864,1989
"2011","Altrincham and Sale West","E14000532",33980,8333,1703,6630,8106,2482,4375,2448,2476,2407,1011,522,489,2342
"2011","Ashton-under-Lyne","E14000537",32834,2356,615,1741,4645,2699,4189,4031,4853,5943,1846,1017,829,2272
"2011","Barrow and Furness","E14000543",32986,4069,1061,3008,5801,1921,3569,4956,3851,5738,1442,861,581,1639
"2011","Birkenhead","E14000559",31343,2632,556,2076,4809,2355,3244,3661,4494,5207,2820,1657,1163,2121
"2011","Blackburn","E14000570",37668,3018,684,2334,4685,2652,4374,4061,5665,6786,2786,1689,1097,3641
"2011","Blackley and Broughton","E14000571",39695,2669,450,2219,4943,2944,4269,3503,5767,6742,4315,3063,1252,4543
"2011","Blackpool North and Cleveleys","E14000572",29763,2344,541,1803,4836,2476,4822,3504,3759,4509,1636,844,792,1877
"2011","Blackpool South","E14000573",29917,1734,389,1345,4321,2054,5149,3457,4101,5183,2090,1146,944,1828
"2011","Bolton North East","E14000578",34435,3442,802,2640,5721,2656,4495,3225,4465,5515,2112,1229,883,2804
"2011","Bolton South East","E14000579",36141,2591,587,2004,4634,2627,4722,3822,5265,6670,2493,1465,1028,3317
"2011","Bolton West","E14000580",34599,4990,1187,3803,6849,2557,4565,3588,3761,4690,1354,740,614,2245
"2011","Bootle","E14000581",35005,2272,505,1767,5025,3498,3884,3572,4907,6003,3149,1790,1359,2695
"2011","Burnley","E14000609",31390,2639,753,1886,4688,1985,3811,3924,4671,5852,1797,1040,757,2023
"2011","Bury North","E14000611",31533,4174,1095,3079,6053,2514,4181,3125,3321,4395,1532,937,595,2238
"2011","Bury South","E14000612",34688,4370,908,3462,6822,2945,4766,3420,3779,4445,1721,980,741,2420
"2011","Carlisle","E14000620",31321,2805,744,2061,5013,2084,3429,4164,4811,5786,1267,692,575,1962
"2011","Cheadle","E14000627",31809,7078,1401,5677,7647,2526,4406,2369,2354,2044,819,409,410,2566
"2011","Chorley","E14000637",35031,5037,1219,3818,7214,2479,4557,3908,3661,5096,1240,674,566,1839
"2011","City of Chester","E14000640",34078,5948,1246,4702,7238,2259,3549,3633,3429,3531,1216,659,557,3275
"2011","Congleton","E14000646",33565,6295,1440,4855,7487,1913,4511,3493,2965,3786,956,439,517,2159
"2011","Copeland","E14000647",30611,4022,1055,2967,5146,1510,3564,5030,3688,4923,1324,828,496,1404
"2011","Crewe and Nantwich","E14000653",39238,4957,1220,3737,7154,2369,3890,5309,4961,5953,1430,713,717,3215
"2011","Denton and Reddish","E14000661",31122,2670,686,1984,4829,2773,3969,4024,4388,5156,1435,758,677,1878
"2011","Eddisbury","E14000686",30741,5398,1491,3907,6328,1567,4955,3154,2873,3598,913,506,407,1955
"2011","Ellesmere Port and Neston","E14000688",31237,3949,1013,2936,5754,1842,3193,4865,4021,4403,1191,615,576,2019
"2011","Fylde","E14000706",29253,5605,1224,4381,6237,2177,4333,2912,2592,2746,965,582,383,1686
"2011","Garston and Halewood","E14000708",34517,3374,652,2722,5650,2772,3619,3847,4795,5037,2799,1737,1062,2624
"2011","Halton","E14000725",34582,2912,777,2135,5367,2485,3453,5146,4677,6423,1955,1136,819,2164
"2011","Hazel Grove","E14000738",28045,4623,1094,3529,5924,2371,4059,2828,2707,2923,983,510,473,1627
"2011","Heywood and Middleton","E14000747",37173,3636,921,2715,5901,2649,4970,4101,4412,6936,2046,1129,917,2522
"2011","Hyndburn","E14000758",33307,2849,863,1986,4946,2069,4636,4277,4505,6017,1727,1061,666,2281
"2011","Knowsley","E14000775",35610,2097,491,1606,4593,2774,4080,4040,5368,6492,3449,2222,1227,2717
"2011","Lancaster and Fleetwood","E14000776",32437,3582,604,2978,5078,1857,4044,3129,3156,3707,1264,786,478,6620
"2011","Leigh","E14000785",38281,3790,994,2796,6583,2896,5047,4654,4664,6762,1830,962,868,2055
"2011","Liverpool, Riverside","E14000793",50035,5378,672,4706,7307,3100,3305,2996,4315,4592,4294,2829,1465,14748
"2011","Liverpool, Walton","E14000794",34241,1452,318,1134,4069,2790,3484,3523,5372,6734,4167,2641,1526,2650
"2011","Liverpool, Wavertree","E14000795",34964,3310,554,2756,5707,2801,3462,2818,4232,4287,3213,1952,1261,5134
"2011","Liverpool, West Derby","E14000796",31703,2046,445,1601,4598,2607,3712,3183,4443,5266,3148,1945,1203,2700
"2011","Macclesfield","E14000802",33755,7099,1561,5538,7622,2033,5026,2971,2877,3119,979,532,447,2029
"2011","Makerfield","E14000805",36724,3371,898,2473,6190,2669,4489,4879,4583,6924,1590,929,661,2029
"2011","Manchester Central","E14000807",55844,5426,649,4777,7730,3850,3432,3613,5510,6050,4366,2966,1400,15867
"2011","Manchester, Gorton","E14000808",42502,3075,361,2714,4924,2776,4131,3030,4797,4808,3564,2442,1122,11397
"2011","Manchester, Withington","E14000809",39099,7567,837,6730,7788,3056,3244,2103,2899,2857,1775,1078,697,7810
"2011","Morecambe and Lunesdale","E14000825",30582,3131,681,2450,5664,1980,4367,3699,3651,4906,1349,798,551,1835
"2011","Oldham East and Saddleworth","E14000870",35704,3638,1018,2620,5936,2342,5163,3777,4316,5938,1999,1169,830,2595
"2011","Oldham West and Royton","E14000871",35777,2704,668,2036,4749,2528,4377,4358,4977,6689,2338,1344,994,3057
"2011","Pendle","E14000875",32035,3050,885,2165,4730,1734,4714,3619,4532,5959,1645,943,702,2052
"2011","Penrith and The Border","E14000877",30178,3412,867,2545,5377,1335,6890,3403,3296,4359,601,343,258,1505
"2011","Preston","E14000885",36386,2597,399,2198,4428,2722,3244,3559,4826,6489,2387,1407,980,6134
"2011","Ribble Valley","E14000894",34972,5348,1430,3918,7144,2311,5535,4085,3395,4293,847,531,316,2014
"2011","Rochdale","E14000897",38038,3002,770,2232,5460,2454,5374,3911,4819,6839,2943,1797,1146,3236
"2011","Rossendale and Darwen","E14000902",35516,4343,1314,3029,6405,2437,5173,3939,4058,5416,1560,855,705,2185
"2011","Salford and Eccles","E14000911",43777,4179,738,3441,7207,3743,3911,4198,5287,6573,2930,1897,1033,5749
"2011","Sefton Central","E14000916",29871,4649,1129,3520,6906,2855,4081,2753,2634,2662,1142,698,444,2189
"2011","South Ribble","E14000943",36552,5115,1268,3847,7534,2827,5289,4029,3724,4665,1260,824,436,2109
"2011","Southport","E14000958",31221,4083,950,3133,6498,2284,4914,2997,3461,3496,1437,803,634,2051
"2011","St Helens North","E14000962",35426,3373,830,2543,6035,2331,3791,4451,4456,6720,2060,1188,872,2209
"2011","St Helens South and Whiston","E14000963",36389,3319,818,2501,5905,2648,3709,4450,4917,6746,2351,1337,1014,2344
"2011","Stalybridge and Hyde","E14000967",33528,3384,930,2454,5497,2659,4431,4011,4561,5148,1793,945,848,2044
"2011","Stockport","E14000969",31002,4063,728,3335,5728,2745,3670,3085,3809,4170,1771,907,864,1961
"2011","Stretford and Urmston","E14000979",35055,4072,768,3304,6315,3232,4081,3557,4469,4594,1811,1001,810,2924
"2011","Tatton","E14000987",29982,7084,1727,5357,7092,1556,4591,2357,2205,2377,863,486,377,1857
"2011","Wallasey","E14001010",31698,2708,629,2079,5598,2789,3702,3780,4376,4408,2230,1307,923,2107
"2011","Warrington North","E14001017",35559,4365,985,3380,6474,2685,3693,3977,4060,6148,1740,984,756,2417
"2011","Warrington South","E14001018",39188,7337,1677,5660,8588,2824,4135,4103,3542,4843,1368,724,644,2448
"2011","Weaver Vale","E14001024",31750,4956,1250,3706,6388,1950,3456,3858,3404,4557,1282,689,593,1899
"2011","West Lancashire","E14001033",33835,4228,1028,3200,6036,2109,4731,3233,3780,4979,1440,747,693,3299
"2011","Westmorland and Lonsdale","E14001037",30131,4345,1045,3300,6153,1429,6080,3339,3080,3564,455,222,233,1686
"2011","Wigan","E14001039",37962,3524,884,2640,5969,2529,4417,4498,5362,7490,2056,1060,996,2117
"2011","Wirral South","E14001043",25230,4120,951,3169,5523,1959,2589,3134,2776,2576,948,580,368,1605
"2011","Wirral West","E14001044",23615,4153,864,3289,5371,1892,2954,2357,2183,2161,894,481,413,1650
"2011","Workington","E14001053",28787,2900,835,2065,4569,1420,3760,4343,3731,5516,1211,703,508,1337
"2011","Worsley and Eccles South","E14001054",35007,3605,847,2758,5782,2711,3995,4078,4479,5968,2073,1145,928,2316
"2011","Wyre and Preston North","E14001057",31573,5692,1274,4418,6834,2321,5219,3205,2601,2792,658,381,277,2251
"2011","Wythenshawe and Sale East","E14001059",37105,4535,802,3733,6568,3097,3792,3715,4604,5611,2495,1436,1059,2688
"2011","Barnsley Central","E14000541",31791,2466,685,1781,4617,1942,3945,3966,4132,6924,1948,1108,840,1851
"2011","Barnsley East","E14000542",32720,2174,660,1514,4559,2043,4106,4279,4222,7545,2129,1289,840,1663
"2011","Batley and Spen","E14000548",38711,3854,1105,2749,6168,2548,5360,4302,5110,6881,1939,995,944,2549
"2011","Beverley and Holderness","E14000556",36321,4823,1428,3395,7800,2431,5442,4397,3435,4647,1213,635,578,2133
"2011","Bradford East","E14000587",38255,2452,612,1840,4685,2568,4905,4105,5416,6730,3608,2260,1348,3786
"2011","Bradford South","E14000588",34826,2640,728,1912,4743,2508,4325,4232,4696,6601,2485,1428,1057,2596
"2011","Bradford West","E14000589",40560,2604,483,2121,4571,2469,5321,3259,4992,6198,4063,2658,1405,7083
"2011","Brigg and Goole","E14000596",31852,3186,1036,2150,5469,1542,4088,4793,3628,6218,1246,659,587,1682
"2011","Calder Valley","E14000614",37611,5665,1509,4156,8036,2400,5509,3734,3888,4752,1488,722,766,2139
"2011","Cleethorpes","E14000643",33624,3027,913,2114,5974,1706,4085,5766,3903,5807,1470,810,660,1886
"2011","Colne Valley","E14000645",39713,5932,1619,4313,7935,2479,5692,4164,4092,5089,1638,875,763,2692
"2011","Dewsbury","E14000666",39680,4641,1340,3301,6587,2307,5831,4141,4099,6557,1923,1121,802,3594
"2011","Don Valley","E14000667",36420,3327,1021,2306,5742,2238,4382,4679,4530,7082,2460,1654,806,1980
"2011","Doncaster Central","E14000668",38690,3132,761,2371,5976,2553,4248,4866,5153,7888,2649,1546,1103,2225
"2011","Doncaster North","E14000669",35365,2381,729,1652,4930,2131,4338,4851,4467,8116,2210,1216,994,1941
"2011","East Yorkshire","E14000683",36339,3969,1232,2737,6778,2113,6464,3911,4211,5350,1560,863,697,1983
"2011","Elmet and Rothwell","E14000689",35662,5987,1554,4433,7743,2516,4744,3892,3191,4383,1242,819,423,1964
"2011","Great Grimsby","E14000716",31906,1827,519,1308,4184,1538,3140,4839,4994,6664,2402,1181,1221,2318
"2011","Halifax","E14000723",36196,3672,903,2769,5692,2517,4608,3800,5041,6109,2241,1165,1076,2516
"2011","Haltemprice and Howden","E14000724",32337,5750,1585,4165,7324,2089,4406,3534,2558,3395,782,452,330,2499
"2011","Harrogate and Knaresborough","E14000730",35836,6742,1642,5100,8708,2424,5131,3131,3233,3419,952,511,441,2096
"2011","Hemsworth","E14000740",34068,3157,865,2292,5234,1934,3796,4172,3861,8335,1717,1037,680,1862
"2011","Huddersfield","E14000756",35546,3419,822,2597,5484,1986,3949,3475,3964,5550,2405,1345,1060,5314
"2011","Keighley","E14000766",33744,4639,1175,3464,6166,2201,5253,3230,3704,4716,1616,841,775,2219
"2011","Kingston upon Hull East","E14000771",33536,1870,534,1336,4324,2144,3235,4621,4906,7541,2867,1433,1434,2028
"2011","Kingston upon Hull North","E14000772",35825,2218,471,1747,4562,1949,2988,3954,4445,6451,2888,1467,1421,6370
"2011","Kingston upon Hull West and Hessle","E14000773",32527,2153,544,1609,4492,1950,3218,4213,4744,6683,2964,1391,1573,2110
"2011","Leeds Central","E14000777",52925,4182,573,3609,6467,3436,3745,4390,6083,8136,4220,2350,1870,12266
"2011","Leeds East","E14000778",32064,2276,523,1753,4398,2147,3883,3672,4484,5856,2705,1551,1154,2643
"2011","Leeds North East","E14000779",32228,6921,1034,5887,7303,2464,3831,1995,2692,2480,1720,955,765,2822
"2011","Leeds North West","E14000780",32724,4996,865,4131,5988,1992,3167,2069,2460,2152,1090,570,520,8810
"2011","Leeds West","E14000781",35121,3153,581,2572,5555,2640,3524,3763,4559,5892,2390,1242,1148,3645
"2011","Morley and Outwood","E14000826",35396,4480,1107,3373,7259,2882,4441,4166,3678,5351,1269,727,542,1870
"2011","Normanton, Pontefract and Castleford","E14000836",39120,2903,855,2048,5633,2459,3708,5766,5552,9220,2007,1141,866,1872
"2011","Penistone and Stocksbridge","E14000876",31800,4292,1176,3116,6204,2094,4597,3697,3489,4646,1010,510,500,1771
"2011","Pudsey","E14000886",31540,5591,1202,4389,7189,2526,4229,3044,2907,3268,853,425,428,1933
"2011","Richmond (Yorks)","E14000895",41199,6013,2091,3922,9257,5166,6612,3923,3186,4304,906,509,397,1832
"2011","Rother Valley","E14000903",34293,3968,1187,2781,6114,2217,4485,4393,4031,5700,1528,855,673,1857
"2011","Rotherham","E14000904",32563,2150,611,1539,4170,1856,3928,3986,4870,6793,2664,1639,1025,2146
"2011","Scarborough and Whitby","E14000913",34856,3114,851,2263,5743,1810,6225,4654,4555,4771,1497,740,757,2487
"2011","Scunthorpe","E14000914",32245,2682,874,1808,4432,1467,2686,5260,4613,7376,1765,965,800,1964
"2011","Selby and Ainsty","E14000917",35035,5509,1521,3988,7117,1993,5083,4127,3644,4683,878,398,480,2001
"2011","Sheffield Central","E14000919",49745,5494,582,4912,6688,2603,3346,2456,4132,3849,2667,1681,986,18510
"2011","Sheffield South East","E14000920",33058,2930,773,2157,4886,2233,4531,4054,4725,5604,1844,1065,779,2251
"2011","Sheffield, Brightside and Hillsborough","E14000921",36435,2167,460,1707,4350,2204,4122,3967,6134,6886,3521,2192,1329,3084
"2011","Sheffield, Hallam","E14000922",32341,7957,1442,6515,7306,1865,3696,1662,1817,1645,785,457,328,5608
"2011","Sheffield, Heeley","E14000923",33251,3281,651,2630,5567,2365,4112,3475,4622,5192,2205,1240,965,2432
"2011","Shipley","E14000925",34237,5819,1398,4421,7652,2783,4468,3249,3281,3644,1192,598,594,2149
"2011","Skipton and Ripon","E14000928",35662,5565,1530,4035,7721,2096,7373,3460,3206,3753,702,341,361,1786
"2011","Thirsk and Malton","E14000993",34822,4812,1457,3355,6686,1671,7386,3737,3591,4335,761,406,355,1843
"2011","Wakefield","E14001009",35359,3495,921,2574,6091,2415,4479,3986,4174,6830,1953,1117,836,1936
"2011","Wentworth and Dearne","E14001028",34487,2595,772,1823,4913,2390,4264,4552,4398,7419,2087,1212,875,1869
"2011","York Central","E14001061",40494,5418,883,4535,7196,2703,3837,3800,4406,4763,1367,679,688,7004
"2011","York Outer","E14001062",33003,5848,1362,4486,7137,2255,4112,3084,3009,3112,595,338,257,3851
"2011","Amber Valley","E14000533",32633,3370,1003,2367,5367,1721,4217,4483,4297,6226,1372,712,660,1580
"2011","Ashfield","E14000535",37366,3029,929,2100,5424,2067,4520,5261,5181,8021,1917,1122,795,1946
"2011","Bassetlaw","E14000546",38333,3903,1200,2703,6397,2116,4607,5024,5118,7305,1777,1131,646,2086
"2011","Bolsover","E14000577",34876,2911,887,2024,5204,1910,4214,4842,4488,7744,1718,1004,714,1845
"2011","Boston and Skegness","E14000582",36540,2322,701,1621,5120,1829,5695,4581,6260,7291,1663,921,742,1779
"2011","Bosworth","E14000583",36051,5130,1378,3752,7241,2160,5154,4190,3528,5765,1019,507,512,1864
"2011","Broxtowe","E14000607",35346,6024,1230,4794,7047,2543,3943,3724,3495,4170,1142,579,563,3258
"2011","Charnwood","E14000625",33837,5215,1344,3871,6860,2367,5172,3598,3237,4100,817,444,373,2471
"2011","Chesterfield","E14000632",34147,3617,849,2768,5965,2445,4093,3970,4676,5689,1754,986,768,1938
"2011","Corby","E14000648",40126,4442,1349,3093,6953,1972,4740,4753,5240,8303,1160,608,552,2563
"2011","Daventry","E14000660",34533,5749,1533,4216,7399,1898,5313,3392,3041,4801,997,595,402,1943
"2011","Derby North","E14000662",37104,4927,983,3944,6472,2331,3519,4096,4299,4666,1654,946,708,5140
"2011","Derby South","E14000663",38294,3406,629,2777,5120,2116,3904,4801,5858,6597,3121,1866,1255,3371
"2011","Derbyshire Dales","E14000664",28882,5316,1416,3900,5676,1222,5633,2772,2481,3513,777,399,378,1492
"2011","Erewash","E14000695",34334,3593,936,2657,5792,2193,4142,4708,4313,6124,1593,732,861,1876
"2011","Gainsborough","E14000707",32934,4226,1281,2945,6744,1871,4881,4052,3562,4540,1236,704,532,1822
"2011","Gedling","E14000710",33165,3930,937,2993,6636,2671,4577,3800,3761,4372,1382,730,652,2036
"2011","Grantham and Stamford","E14000714",36921,5070,1544,3526,7485,2190,4970,4458,4386,5201,1090,552,538,2071
"2011","Harborough","E14000728",35980,5793,1404,4389,7338,2530,5017,3320,3323,4149,956,551,405,3554
"2011","High Peak","E14000748",33610,5011,1279,3732,6312,1972,5097,3911,3742,4149,1204,616,588,2212
"2011","Kettering","E14000769",33691,4233,1152,3081,6494,2043,4513,3777,3915,5707,1177,624,553,1832
"2011","Leicester East","E14000782",38172,2692,499,2193,4356,2894,4060,3300,6924,6914,2807,1771,1036,4225
"2011","Leicester South","E14000783",44892,4252,680,3572,5389,2858,3816,3032,5109,6440,3282,1937,1345,10714
"2011","Leicester West","E14000784",37066,2671,476,2195,4763,2277,3429,3576,5345,7616,2781,1654,1127,4608
"2011","Lincoln","E14000792",39869,3689,984,2705,6771,2778,4162,4362,5103,5921,2004,1125,879,5079
"2011","Loughborough","E14000797",39201,5278,1001,4277,6314,1973,3626,3762,3693,4241,1182,636,546,9132
"2011","Louth and Horncastle","E14000798",34862,3254,1122,2132,6266,1901,6281,4544,4319,5172,1396,852,544,1729
"2011","Mansfield","E14000810",38348,3074,966,2108,6005,2425,4513,5159,5053,8011,2046,1234,812,2062
"2011","Mid Derbyshire","E14000814",29977,5632,1387,4245,6719,1882,3490,3617,2966,3151,750,392,358,1770
"2011","Newark","E14000829",36816,5623,1529,4094,7460,2113,5490,3628,3812,5218,1364,892,472,2108
"2011","North East Derbyshire","E14000843",33378,4137,1178,2959,6302,2073,4727,3711,3989,5238,1311,717,594,1890
"2011","North West Leicestershire","E14000858",34245,4842,1291,3551,6468,1941,4422,4163,3674,5720,1047,570,477,1968
"2011","Northampton North","E14000861",30788,2876,594,2282,5082,2327,3740,3147,3736,5334,1431,775,656,3115
"2011","Northampton South","E14000862",35028,3631,757,2874,6114,2485,4002,3602,4140,6380,1806,980,826,2868
"2011","Nottingham East","E14000865",40231,3421,540,2881,5665,2746,3634,3138,4357,5607,3500,2209,1291,8163
"2011","Nottingham North","E14000866",32491,1694,390,1304,3857,2038,3099,3764,5044,7240,3161,1871,1290,2594
"2011","Nottingham South","E14000867",45380,4561,697,3864,5329,2249,3458,3137,3804,4985,2199,1313,886,15658
"2011","Rushcliffe","E14000908",33881,8087,1667,6420,8388,2073,4239,2482,2325,2499,822,435,387,2966
"2011","Rutland and Melton","E14000909",36991,6288,1930,4358,8140,1999,5626,3737,3583,4276,896,526,370,2446
"2011","Sherwood","E14000924",34109,3653,1035,2618,6237,2247,4354,4496,3939,5921,1398,813,585,1864
"2011","Sleaford and North Hykeham","E14000929",39568,5788,2150,3638,9134,2764,5801,4432,3914,4672,1009,579,430,2054
"2011","South Derbyshire","E14000935",34586,5239,1396,3843,6752,1938,4288,4510,3910,4978,938,513,425,2033
"2011","South Holland and The Deepings","E14000939",36245,3639,1171,2468,6220,1896,5654,4439,5003,6579,1166,575,591,1649
"2011","South Leicestershire","E14000940",36766,5578,1499,4079,7700,2506,5322,4008,3373,5096,940,561,379,2243
"2011","South Northamptonshire","E14000942",39014,7725,1962,5763,9750,2469,5848,3483,3083,3844,655,317,338,2157
"2011","Wellingborough","E14001025",38207,4148,1075,3073,6917,2454,4706,4414,4392,7386,1635,893,742,2155
"2011","Aldridge-Brownhills","E14000531",27539,3257,985,2272,5182,1862,3908,3190,3157,4014,1359,684,675,1610
"2011","Birmingham, Edgbaston","E14000560",35400,5710,806,4904,5834,2246,3183,2619,3472,3564,2579,1438,1141,6193
"2011","Birmingham, Erdington","E14000561",33457,2147,406,1741,4494,2190,3509,3486,5453,5947,3417,1873,1544,2814
"2011","Birmingham, Hall Green","E14000562",40399,4432,580,3852,6156,2797,5126,2889,5099,4716,4042,2480,1562,5142
"2011","Birmingham, Hodge Hill","E14000563",38065,1584,301,1283,3365,2203,5029,3495,6161,6377,5005,3085,1920,4846
"2011","Birmingham, Ladywood","E14000564",48191,4262,502,3760,5586,2616,3662,3345,5660,6074,6045,3730,2315,10941
"2011","Birmingham, Northfield","E14000565",34651,3065,646,2419,5441,2698,3624,3905,4996,5285,2962,1588,1374,2675
"2011","Birmingham, Perry Barr","E14000566",37235,2483,477,2006,4610,2571,4401,3512,5367,5642,3637,2169,1468,5012
"2011","Birmingham, Selly Oak","E14000567",37761,4256,677,3579,5862,2448,3479,2996,4043,4134,2437,1456,981,8106
"2011","Birmingham, Yardley","E14000568",36182,2382,441,1941,4576,2587,4374,4081,5703,6123,3252,1849,1403,3104
"2011","Bromsgrove","E14000605",33901,6327,1690,4637,7497,1976,5227,3222,2879,3436,1211,741,470,2126
"2011","Burton","E14000610",37976,4293,1126,3167,6162,1922,4582,4682,5302,7133,1563,1002,561,2337
"2011","Cannock Chase","E14000618",35953,3229,938,2291,5872,2244,5336,4718,4380,6547,1573,762,811,2054
"2011","Coventry North East","E14000649",38951,2935,517,2418,4894,2601,3787,4085,6029,7342,2834,1629,1205,4444
"2011","Coventry North West","E14000650",36799,3828,770,3058,5723,2699,3744,4196,4921,5514,1770,994,776,4404
"2011","Coventry South","E14000651",41147,4795,795,4000,5737,2230,3350,3290,4051,4792,2105,1255,850,10797
"2011","Dudley North","E14000671",28757,2685,780,1905,4281,1813,3471,3426,4002,5141,2001,1044,957,1937
"2011","Dudley South","E14000672",29080,2728,879,1849,4571,2010,3523,3425,4222,5151,1731,815,916,1719
"2011","Halesowen and Rowley Regis","E14000722",31207,3273,903,2370,5429,2336,3743,3398,4267,4934,1717,836,881,2110
"2011","Hereford and South Herefordshire","E14000743",35412,3936,1092,2844,6512,1843,6093,3753,4756,5059,1332,837,495,2128
"2011","Kenilworth and Southam","E14000767",29570,6965,1692,5273,6864,1501,4300,2438,2023,2299,562,287,275,2618
"2011","Lichfield","E14000791",34016,5736,1610,4126,7742,1998,4924,3480,3242,4051,1011,548,463,1832
"2011","Ludlow","E14000799",31064,4438,1264,3174,5995,1388,7056,3055,3187,3627,804,419,385,1514
"2011","Meriden","E14000812",38119,6445,1657,4788,7436,2440,4674,3662,4141,4777,2106,1177,929,2438
"2011","Mid Worcestershire","E14000818",34311,5437,1528,3909,7100,1887,5558,3532,3460,4394,1055,555,500,1888
"2011","Newcastle-under-Lyme","E14000834",33149,3684,812,2872,5229,2047,3616,3465,3712,5719,1318,701,617,4359
"2011","North Herefordshire","E14000847",31041,4463,1250,3213,6026,1466,7099,2724,3349,3399,890,512,378,1625
"2011","North Shropshire","E14000849",38351,4693,1458,3235,7164,2188,6749,4045,4467,5222,1411,816,595,2412
"2011","North Warwickshire","E14000854",33059,3301,913,2388,5491,2052,4458,4287,4420,6118,1195,603,592,1737
"2011","Nuneaton","E14000868",33326,3433,855,2578,5645,2173,3532,4129,4384,6522,1524,778,746,1984
"2011","Redditch","E14000892",33209,4148,1192,2956,6076,1978,4341,3776,4557,5109,1162,561,601,2062
"2011","Rugby","E14000905",35362,5299,1248,4051,6881,2221,3922,4225,3741,5827,1119,585,534,2127
"2011","Shrewsbury and Atcham","E14000926",37446,5176,1256,3920,7618,2343,5648,3768,4553,4514,1298,732,566,2528
"2011","Solihull","E14000931",34447,6915,1513,5402,7917,2621,4355,3216,3043,2783,1046,557,489,2551
"2011","South Staffordshire","E14000945",34863,5037,1493,3544,7272,2304,5471,3669,3335,4218,1406,834,572,2151
"2011","Stafford","E14000965",36595,5312,1320,3992,7517,2687,4138,3642,3532,4499,1311,732,579,3957
"2011","Staffordshire Moorlands","E14000966",28649,3524,1015,2509,5178,1688,5233,3372,3056,4276,814,460,354,1508
"2011","Stoke-on-Trent Central","E14000972",32282,1912,437,1475,3723,2000,3351,3434,4456,6816,2070,1199,871,4520
"2011","Stoke-on-Trent North","E14000973",34985,2197,647,1550,4287,2090,4119,4534,5314,8142,2068,1263,805,2234
"2011","Stoke-on-Trent South","E14000974",32611,2354,640,1714,4415,2125,3655,4217,4692,7339,1783,1046,737,2031
"2011","Stone","E14000975",31130,5246,1424,3822,6670,1885,5001,3061,2950,3723,820,489,331,1774
"2011","Stourbridge","E14000976",32754,3970,1142,2828,6087,2286,4524,3498,4028,4645,1610,731,879,2106
"2011","Stratford-on-Avon","E14000977",31421,6259,1664,4595,7258,1685,5487,2708,2722,2938,684,371,313,1680
"2011","Sutton Coldfield","E14000985",33318,7040,1694,5346,8446,2513,4385,2639,2577,2488,1043,542,501,2187
"2011","Tamworth","E14000986",35121,4133,1185,2948,6369,2155,4284,4315,4315,6049,1425,774,651,2076
"2011","Telford","E14000989",33233,3328,907,2421,5413,2100,3256,4278,5001,5866,1881,1015,866,2110
"2011","The Wrekin","E14000992",33687,4555,1258,3297,6742,2459,3723,3627,4052,4440,1159,632,527,2930
"2011","Walsall North","E14001011",33146,1946,624,1322,3948,1841,3875,4029,5277,7136,3022,1553,1469,2072
"2011","Walsall South","E14001012",34349,2896,641,2255,4794,2020,4078,3484,5186,5763,3011,1664,1347,3117
"2011","Warley","E14001016",32167,2266,459,1807,4198,2055,3478,3226,5138,5802,2918,1688,1230,3086
"2011","Warwick and Leamington","E14001019",37373,7547,1339,6208,7530,2166,3746,3091,3587,3642,1167,581,586,4897
"2011","West Bromwich East","E14001029",31117,2001,493,1508,3963,1966,3484,3529,5001,6255,2630,1453,1177,2288
"2011","West Bromwich West","E14001030",32161,1838,527,1311,3867,1989,3120,3852,5605,7020,2691,1354,1337,2179
"2011","West Worcestershire","E14001035",32335,6155,1490,4665,6989,1523,5853,2817,2915,3105,928,487,441,2050
"2011","Wolverhampton North East","E14001049",31216,1887,484,1403,3943,1847,3124,3578,5300,6076,2823,1464,1359,2638
"2011","Wolverhampton South East","E14001050",31442,1793,465,1328,3552,1781,3074,3425,5578,6479,3198,1712,1486,2562
"2011","Wolverhampton South West","E14001051",31712,3784,871,2913,5798,2095,3830,2620,3749,3861,2337,1167,1170,3638
"2011","Worcester","E14001052",36455,5080,1081,3999,7207,2365,3906,3822,4326,4807,1472,748,724,3470
"2011","Wyre Forest","E14001058",35907,4371,1301,3070,6582,2001,5253,4056,4130,6009,1589,846,743,1916
"2011","Basildon and Billericay","E14000544",30980,4541,972,3569,6267,2454,4864,3030,2942,3797,1303,652,651,1782
"2011","Bedford","E14000552",36322,4375,839,3536,6201,2513,4326,3559,4061,5576,2049,1113,936,3662
"2011","Braintree","E14000590",34973,4740,1267,3473,7344,2218,6309,3804,3411,4234,1105,550,555,1808
"2011","Brentwood and Ongar","E14000594",32749,6420,1460,4960,8103,2405,5781,2560,2115,2377,875,454,421,2113
"2011","Broadland","E14000603",33955,4504,1174,3330,7140,2238,6084,3747,3631,3946,930,569,361,1735
"2011","Broxbourne","E14000606",34633,4171,1023,3148,6700,2531,6830,3490,3043,4284,1192,589,603,2392
"2011","Bury St Edmunds","E14000613",41555,6175,1939,4236,9295,3252,5398,4369,4406,5569,975,593,382,2116
"2011","Cambridge","E14000617",47667,10760,982,9778,7240,2049,3325,2762,3264,3370,1252,689,563,13645
"2011","Castle Point","E14000622",31762,3588,869,2719,5991,2662,6148,3759,2961,3944,1063,566,497,1646
"2011","Central Suffolk and North Ipswich","E14000624",34727,5357,1178,4179,7430,2214,5915,3383,3287,4249,858,453,405,2034
"2011","Chelmsford","E14000628",38368,6992,1349,5643,9286,3352,4559,3431,3500,3546,1162,543,619,2540
"2011","Clacton","E14000642",28222,1982,524,1458,4396,1817,5451,3153,3687,4478,1752,989,763,1506
"2011","Colchester","E14000644",40273,5453,1457,3996,9068,3332,4366,3552,4192,4150,1616,901,715,4544
"2011","Epping Forest","E14000693",33466,5461,1277,4184,7490,2383,6737,2573,2409,2969,1127,589,538,2317
"2011","Great Yarmouth","E14000717",34916,2543,730,1813,5384,2020,5066,4627,5077,6090,1989,999,990,2120
"2011","Harlow","E14000729",32295,3347,839,2508,6035,2276,4981,3646,3513,5056,1335,598,737,2106
"2011","Harwich and North Essex","E14000734",32732,4466,1122,3344,6608,2017,5404,3300,3103,3634,1158,653,505,3042
"2011","Hemel Hempstead","E14000739",35404,5293,1155,4138,7790,2636,5263,3268,3404,4202,1186,606,580,2362
"2011","Hertford and Stortford","E14000744",38287,7991,1804,6187,9808,2555,5369,3195,2683,3221,860,451,409,2605
"2011","Hertsmere","E14000745",34593,6149,1410,4739,7994,2330,5889,2640,2608,2897,1217,699,518,2869
"2011","Hitchin and Harpenden","E14000749",34889,9067,1955,7112,9349,2209,4366,2259,2194,2447,774,370,404,2224
"2011","Huntingdon","E14000757",42030,7379,1981,5398,9405,2911,4707,4429,4475,5046,1338,777,561,2340
"2011","Ipswich","E14000761",40151,4482,806,3676,6951,3106,4528,4390,5391,6623,2102,1027,1075,2578
"2011","Luton North","E14000800",33644,3099,577,2522,5392,2273,5084,3620,4030,4971,1760,1014,746,3415
"2011","Luton South","E14000801",41759,3377,665,2712,5671,2610,5479,4282,4933,6411,2452,1374,1078,6544
"2011","Maldon","E14000806",32292,5443,1356,4087,7243,2151,5984,3118,2695,3103,873,423,450,1682
"2011","Mid Bedfordshire","E14000813",36797,6577,1695,4882,8729,2459,5760,3452,2482,3320,774,375,399,3244
"2011","Mid Norfolk","E14000816",35677,4234,1189,3045,6833,2365,5905,4168,4209,4934,1177,708,469,1852
"2011","North East Bedfordshire","E14000841",36931,6948,1723,5225,8621,2417,5782,3492,2944,3652,891,460,431,2184
"2011","North East Cambridgeshire","E14000842",40670,3571,1004,2567,6432,2352,6450,5189,5995,7014,1708,964,744,1959
"2011","North East Hertfordshire","E14000845",33923,6525,1552,4973,7787,2033,5196,3097,2840,3475,860,394,466,2110
"2011","North Norfolk","E14000848",29729,3045,844,2201,5673,1589,6293,3282,3673,3823,1099,633,466,1252
"2011","North West Cambridgeshire","E14000855",45551,7072,1868,5204,10104,3511,5745,4974,4556,5800,1338,737,601,2451
"2011","North West Norfolk","E14000859",33595,3169,948,2221,5739,1790,5265,4235,5186,5137,1356,736,620,1718
"2011","Norwich North","E14000863",31990,3188,695,2493,5700,2682,4159,3781,4276,5160,1308,720,588,1736
"2011","Norwich South","E14000864",36656,4901,680,4221,6408,2516,3598,3022,3944,4542,1650,857,793,6075
"2011","Peterborough","E14000878",41303,3712,786,2926,5986,3041,4658,4562,6199,8034,2248,1333,915,2863
"2011","Rayleigh and Wickford","E14000888",34915,5280,1203,4077,8130,3325,6012,3583,2819,3181,846,416,430,1739
"2011","Rochford and Southend East","E14000899",35899,4037,870,3167,7016,2990,5401,3539,4119,4350,2091,1028,1063,2356
"2011","Saffron Walden","E14000910",36382,7284,1844,5440,8955,2202,6377,2953,2552,2937,713,334,379,2409
"2011","South Basildon and East Thurrock","E14000933",34847,3273,721,2552,6131,2692,5782,4451,3777,5241,1516,793,723,1984
"2011","South Cambridgeshire","E14000934",39263,10177,1906,8271,8828,1997,5081,3270,2919,3165,727,414,313,3099
"2011","South East Cambridgeshire","E14000937",41759,8642,1795,6847,9247,2546,6092,4002,3764,4279,877,489,388,2310
"2011","South Norfolk","E14000941",34838,5410,1272,4138,7427,2156,6142,3485,3588,3934,894,512,382,1802
"2011","South Suffolk","E14000946",32552,4820,1327,3493,7155,1795,5745,3253,3322,3812,891,434,457,1759
"2011","South West Bedfordshire","E14000949",36975,5180,1225,3955,7982,2722,5283,3980,3432,4763,1228,609,619,2405
"2011","South West Hertfordshire","E14000951",37022,8350,2089,6261,9603,2265,5668,2622,2354,2717,1013,565,448,2430
"2011","South West Norfolk","E14000952",37398,3619,1310,2309,6781,2383,5929,4794,4845,6040,1172,595,577,1835
"2011","Southend West","E14000957",31631,4606,946,3660,7072,2859,5342,2942,2796,3036,1174,643,531,1804
"2011","St Albans","E14000960",34996,8743,1644,7099,9431,2151,4345,2202,2278,2369,981,522,459,2496
"2011","Stevenage","E14000968",33882,4773,932,3841,6866,2484,4662,3507,3623,4324,1259,600,659,2384
"2011","Suffolk Coastal","E14000981",34860,4973,1088,3885,7196,2595,5579,3534,3689,4566,980,518,462,1748
"2011","Thurrock","E14000995",41706,3609,781,2828,7077,3061,5617,5146,4732,7716,2242,1179,1063,2506
"2011","Watford","E14001021",41547,6568,1230,5338,9483,3186,5943,3761,3989,4099,1333,693,640,3185
"2011","Waveney","E14001022",36060,3201,883,2318,6254,2175,5026,4862,5066,5933,1519,835,684,2024
"2011","Welwyn Hatfield","E14001027",38784,5950,1178,4772,7444,2275,4415,3119,3381,3894,1102,545,557,7204
"2011","West Suffolk","E14001034",42458,4633,1509,3124,8426,3051,6042,5238,4721,6913,1340,797,543,2094
"2011","Witham","E14001045",31879,4856,1194,3662,7047,2399,5167,3158,3054,3548,947,461,486,1703
"2011","Barking","E14000540",40882,2696,425,2271,5496,2967,5881,3941,5340,5799,3435,2053,1382,5327
"2011","Battersea","E14000549",42367,11836,2271,9565,12857,2495,3860,2053,2373,2415,1614,913,701,2864
"2011","Beckenham","E14000551",30348,6362,1314,5048,8386,2758,4792,1856,1731,1456,824,418,406,2183
"2011","Bermondsey and Old Southwark","E14000553",52549,10407,1720,8687,11861,3203,4358,3448,4081,4253,3057,1834,1223,7881
"2011","Bethnal Green and Bow","E14000555",50351,7066,1023,6043,11061,3316,4278,3436,4794,4065,3932,2347,1585,8403
"2011","Bexleyheath and Crayford","E14000558",30228,3407,736,2671,5804,3027,4744,3459,2852,3379,1217,656,561,2339
"2011","Brent Central","E14000591",51213,4597,657,3940,8011,3141,8541,4136,5478,6359,4191,2757,1434,6759
"2011","Brent North","E14000592",49189,5962,841,5121,7870,3461,8632,3247,5326,4479,2817,1947,870,7395
"2011","Brentford and Isleworth","E14000593",49283,9045,1545,7500,11760,3355,6333,3529,3936,3755,2140,1296,844,5430
"2011","Bromley and Chislehurst","E14000604",30159,6035,1234,4801,7400,2336,4695,2145,2168,2130,1128,602,526,2122
"2011","Camberwell and Peckham","E14000615",45929,5205,836,4369,9182,3016,4701,3718,4882,5184,3817,2284,1533,6224
"2011","Carshalton and Wallington","E14000621",33460,4328,884,3444,6961,3037,5591,3196,3020,3302,1425,810,615,2600
"2011","Chelsea and Fulham","E14000629",40277,11284,3165,8119,12010,1881,4300,1579,1994,1877,1560,943,617,3792
"2011","Chingford and Woodford Green","E14000634",30934,4848,959,3889,6771,2569,5573,2334,2292,2495,1445,843,602,2607
"2011","Chipping Barnet","E14000636",39351,7616,1353,6263,9521,2709,6802,2291,2627,2319,1822,1144,678,3644
"2011","Cities of London and Westminster","E14000639",49268,13904,3947,9957,13557,2628,4380,1877,2229,2049,2418,1656,762,6226
"2011","Croydon Central","E14000654",39857,5710,939,4771,8273,3639,5443,3409,3863,3664,2261,1311,950,3595
"2011","Croydon North","E14000655",47445,4718,761,3957,8504,4209,6566,3747,5425,4608,3539,2116,1423,6129
"2011","Croydon South","E14000656",40128,7905,1418,6487,10036,3539,5819,2808,2762,2572,1573,941,632,3114
"2011","Dagenham and Rainham","E14000657",34287,2450,501,1949,5070,2825,5597,3781,4234,5033,2127,1148,979,3170
"2011","Dulwich and West Norwood","E14000673",39854,7454,1246,6208,10464,2677,4401,2308,3096,3138,2610,1504,1106,3706
"2011","Ealing Central and Acton","E14000674",46056,9554,1659,7895,11776,2926,6182,2646,2864,2970,2311,1400,911,4827
"2011","Ealing North","E14000675",43463,4960,867,4093,7413,3052,7685,3765,4476,4900,2607,1654,953,4605
"2011","Ealing, Southall","E14000676",37453,3757,577,3180,6172,2542,4803,3109,4557,4440,2979,2031,948,5094
"2011","East Ham","E14000679",58725,4290,576,3714,7272,3802,7023,4407,7617,5738,4979,3503,1476,13597
"2011","Edmonton","E14000687",37198,2663,525,2138,5289,2567,5454,3363,4727,4761,3575,2371,1204,4799
"2011","Eltham","E14000690",32146,4061,799,3262,6223,2559,4978,2713,3084,3126,2125,1428,697,3277
"2011","Enfield North","E14000691",34403,3839,742,3097,6343,2603,5475,2993,3439,3939,2510,1603,907,3262
"2011","Enfield, Southgate","E14000692",35658,6476,1222,5254,8225,2404,6246,2095,2475,2315,1763,1089,674,3659
"2011","Erith and Thamesmead","E14000696",38175,3224,638,2586,5938,3064,5213,3778,4810,4885,2765,1772,993,4498
"2011","Feltham and Heston","E14000701",46696,4208,606,3602,7421,4150,5880,4965,5623,6236,2626,1737,889,5587
"2011","Finchley and Golders Green","E14000703",42399,9336,1672,7664,10350,2452,6800,1999,2685,2209,1937,1247,690,4631
"2011","Greenwich and Woolwich","E14000718",42526,6818,1216,5602,9186,2759,4323,2822,4011,3818,3195,2134,1061,5594
"2011","Hackney North and Stoke Newington","E14000720",47164,5898,970,4928,11455,3146,5582,2832,4034,4155,4661,3165,1496,5401
"2011","Hackney South and Shoreditch","E14000721",45649,6198,933,5265,10632,2989,4834,2845,4300,4175,4353,2690,1663,5323
"2011","Hammersmith","E14000726",46693,9109,1557,7552,11664,2847,4686,2873,3236,3424,2922,1878,1044,5932
"2011","Hampstead and Kilburn","E14000727",49385,12197,2325,9872,13914,2692,5413,2324,2899,2843,2497,1520,977,4606
"2011","Harrow East","E14000731",37205,5808,930,4878,6983,2902,7058,2312,3148,2721,1869,1232,637,4404
"2011","Harrow West","E14000732",38620,6764,925,5839,8130,3058,5281,2531,3351,2651,1929,1264,665,4925
"2011","Hayes and Harlington","E14000737",39462,2973,503,2470,5812,3105,5106,4602,4822,5454,2539,1683,856,5049
"2011","Hendon","E14000741",43232,6692,1127,5565,8142,2549,8004,2610,3611,3159,2409,1642,767,6056
"2011","Holborn and St Pancras","E14000750",53402,9740,1488,8252,12191,2710,5076,2839,3858,3254,3273,2123,1150,10461
"2011","Hornchurch and Upminster","E14000751",35823,4704,979,3725,7135,3441,6041,3586,3126,3733,1488,829,659,2569
"2011","Hornsey and Wood Green","E14000752",47852,9518,1483,8035,13437,3038,6252,2548,3130,2979,2614,1613,1001,4336
"2011","Ilford North","E14000759",35672,5390,816,4574,7281,2833,6367,2467,3095,2606,1739,1016,723,3894
"2011","Ilford South","E14000760",47060,5933,748,5185,8032,3562,6919,2919,4973,3485,3310,2160,1150,7927
"2011","Islington North","E14000763",39726,7769,1120,6649,10386,2520,3930,2233,3059,2921,2835,1766,1069,4073
"2011","Islington South and Finsbury","E14000764",41582,9298,1491,7807,9947,2273,3687,2055,2823,2972,2587,1714,873,5940
"2011","Kensington","E14000768",46133,11743,3736,8007,13163,2014,4824,1826,2502,2277,2502,1552,950,5282
"2011","Kingston and Surbiton","E14000770",44056,8260,1463,6797,10516,3227,5774,2883,3275,2831,1483,832,651,5807
"2011","Lewisham East","E14000787",35561,4750,851,3899,7552,2772,4733,2811,3605,3285,2476,1458,1018,3577
"2011","Lewisham West and Penge","E14000788",38160,5519,960,4559,9102,3026,4976,2875,3534,3273,2455,1440,1015,3400
"2011","Lewisham, Deptford","E14000789",43662,5700,890,4810,10097,3324,4489,3228,4171,3595,3001,1819,1182,6057
"2011","Leyton and Wanstead","E14000790",40340,4779,726,4053,7699,2786,6543,2892,3699,3437,2609,1683,926,5896
"2011","Mitcham and Morden","E14000823",37919,3694,610,3084,6565,2956,6295,3407,4270,4132,2021,1223,798,4579
"2011","Old Bexley and Sidcup","E14000869",30016,4176,864,3312,6471,2970,5195,3004,2429,2422,870,488,382,2479
"2011","Orpington","E14000872",30325,5558,1189,4369,7487,2720,4745,2479,2251,2103,965,531,434,2017
"2011","Poplar and Limehouse","E14000882",51817,10607,1848,8759,11757,3170,4109,3549,4431,3754,3880,2315,1565,6560
"2011","Putney","E14000887",34508,8611,1708,6903,9596,2060,3858,1822,2067,1936,1334,838,496,3224
"2011","Richmond Park","E14000896",41843,12088,2705,9383,12644,2153,4835,1660,1966,1577,1131,602,529,3789
"2011","Romford","E14000900",34050,4121,858,3263,6867,3211,6339,3475,3045,3386,1333,714,619,2273
"2011","Ruislip, Northwood and Pinner","E14000906",32666,7606,1507,6099,8355,2371,4970,2152,1926,1802,1045,561,484,2439
"2011","Streatham","E14000978",44024,7685,1309,6376,11262,3197,5398,3048,3342,3492,2780,1705,1075,3820
"2011","Sutton and Cheam","E14000984",34261,5928,1032,4896,8179,2987,5613,2929,2728,2446,1028,583,445,2423
"2011","Tooting","E14000998",41012,8826,1560,7266,11183,2819,4871,2119,2829,2490,2053,1321,732,3822
"2011","Tottenham","E14001002",47707,3703,455,3248,7734,2998,6754,3918,5326,5702,4955,3480,1475,6617
"2011","Twickenham","E14001005",40566,10115,2091,8024,12201,2695,4875,2165,2102,1985,1133,650,483,3295
"2011","Uxbridge and South Ruislip","E14001007",37999,4895,990,3905,7189,3013,4765,3642,2859,3384,1284,727,557,6968
"2011","Vauxhall","E14001008",47921,9452,1549,7903,12749,3218,4048,2865,3696,4044,2941,1763,1178,4908
"2011","Walthamstow","E14001013",41063,3528,618,2910,7392,2923,6817,3323,4508,4297,3082,1893,1189,5193
"2011","West Ham","E14001032",62203,4784,710,4074,8697,3765,8686,4862,7377,6675,5073,3396,1677,12284
"2011","Westminster North","E14001036",44158,9939,2338,7601,11185,2236,4140,2317,2973,2863,3681,2625,1056,4824
"2011","Wimbledon","E14001040",36102,10389,1947,8442,10724,2416,4047,1803,1701,1483,884,484,400,2655
"2011","Aldershot","E14000530",38805,5646,1362,4284,8792,3745,4464,4408,4080,4015,1194,671,523,2461
"2011","Arundel and South Downs","E14000534",33304,6874,1692,5182,8140,1813,6346,2675,2397,2477,662,360,302,1920
"2011","Ashford","E14000536",39261,5418,1328,4090,8122,2509,6503,4499,3995,4405,1329,754,575,2481
"2011","Aylesbury","E14000538",38956,6536,1834,4702,8986,2944,5603,3722,3597,4104,1237,729,508,2227
"2011","Banbury","E14000539",42953,6321,1632,4689,9069,2858,5527,4665,4956,6051,1106,676,430,2400
"2011","Basingstoke","E14000545",39365,7165,1341,5824,8881,3122,4053,3992,3867,5040,1050,525,525,2195
"2011","Beaconsfield","E14000550",34673,7934,2220,5714,9092,1929,5591,2688,2115,2427,711,377,334,2186
"2011","Bexhill and Battle","E14000557",33772,4890,1219,3671,7262,2218,7339,2964,2935,2961,1229,749,480,1974
"2011","Bognor Regis and Littlehampton","E14000576",34449,3521,992,2529,6252,2207,5954,3914,4312,4795,1459,816,643,2035
"2011","Bracknell","E14000586",38543,7790,2035,5755,9373,2883,4750,3663,3133,3543,1076,591,485,2332
"2011","Brighton, Kemptown","E14000597",34618,3668,676,2992,6693,2426,5660,2675,3371,3591,1407,788,619,5127
"2011","Brighton, Pavilion","E14000598",41725,6162,956,5206,9628,2973,5469,2421,2995,2596,1240,625,615,8241
"2011","Buckingham","E14000608",35088,7409,2018,5391,8728,1877,6009,2648,2321,2822,736,421,315,2538
"2011","Canterbury","E14000619",39916,5238,1017,4221,7336,2324,5013,2905,3161,3212,1365,880,485,9362
"2011","Chatham and Aylesford","E14000626",35180,3514,813,2701,6248,2651,5019,4189,3935,5672,1645,844,801,2307
"2011","Chesham and Amersham","E14000631",31787,7886,2044,5842,8687,1643,4972,1934,1949,1857,779,422,357,2080
"2011","Chichester","E14000633",35808,6394,1681,4713,7996,1979,6382,3108,3066,3167,917,487,430,2799
"2011","Crawley","E14000652",38417,4769,867,3902,7373,3627,4416,4742,4432,5178,1445,744,701,2435
"2011","Dartford","E14000659",37036,4532,1054,3478,7510,3250,5717,4329,3655,4549,1292,649,643,2202
"2011","Dover","E14000670",35144,3086,807,2279,6815,2861,4964,4424,4456,4707,1716,1011,705,2115
"2011","East Hampshire","E14000680",33593,6650,1747,4903,8299,1887,5373,2952,2723,2830,777,471,306,2102
"2011","East Surrey","E14000681",37253,7057,1661,5396,9428,2777,6093,3207,2714,2624,1098,663,435,2255
"2011","East Worthing and Shoreham","E14000682",33327,4228,925,3303,7068,2636,5783,3612,3375,3635,1001,543,458,1989
"2011","Eastbourne","E14000684",36673,4073,945,3128,7366,2641,5958,3671,4025,4294,1457,777,680,3188
"2011","Eastleigh","E14000685",37556,5696,1232,4464,8291,2667,5194,4424,3698,4383,1064,604,460,2139
"2011","Epsom and Ewell","E14000694",36343,7866,1642,6224,9392,2702,5579,2537,2404,2186,915,519,396,2762
"2011","Esher and Walton","E14000697",37073,9433,2407,7026,10315,2085,5448,2249,2064,2042,901,487,414,2536
"2011","Fareham","E14000699",35208,6421,1637,4784,8773,2631,4483,3669,2813,3269,773,429,344,2376
"2011","Faversham and Mid Kent","E14000700",32625,4906,1254,3652,7166,2001,5385,3173,2984,4031,1045,635,410,1934
"2011","Folkestone and Hythe","E14000704",40672,4456,1233,3223,8242,3150,6601,4417,4333,4872,2119,1241,878,2482
"2011","Gillingham and Rainham","E14000711",35928,3830,858,2972,6649,2889,5120,3954,3826,4714,1471,786,685,3475
"2011","Gosport","E14000713",34371,4504,1484,3020,7662,2605,3911,4316,3701,4444,1161,633,528,2067
"2011","Gravesham","E14000715",36216,3841,908,2933,6551,2485,5487,4155,4079,5470,1742,971,771,2406
"2011","Guildford","E14000719",39517,8862,1615,7247,8969,1985,4505,2668,2632,2565,835,403,432,6496
"2011","Hastings and Rye","E14000735",38906,3506,853,2653,7181,2733,7498,3750,4469,4805,2484,1384,1100,2480
"2011","Havant","E14000736",31972,4223,1050,3173,5917,2029,5120,3464,3620,4276,1384,771,613,1939
"2011","Henley","E14000742",34842,7988,2100,5888,8541,1897,5551,2874,2335,2884,683,385,298,2089
"2011","Horsham","E14000753",36871,7848,1746,6102,9164,2547,5096,3356,2790,2740,871,480,391,2459
"2011","Hove","E14000755",37427,6125,1111,5014,9667,3100,5939,2580,3046,2738,1349,754,595,2883
"2011","Isle of Wight","E14000762",49344,5233,1355,3878,9102,3078,9018,5498,5829,6465,2268,1239,1029,2853
"2011","Lewes","E14000786",30364,4788,1034,3754,6938,1949,5353,2669,2642,3177,983,556,427,1865
"2011","Maidenhead","E14000803",36296,9038,2083,6955,9516,2078,5125,2696,2449,2379,889,422,467,2126
"2011","Maidstone and The Weald","E14000804",36638,5397,1254,4143,8587,2767,5595,3455,3303,4177,1058,568,490,2299
"2011","Meon Valley","E14000811",32013,6541,1734,4807,7527,2077,5263,2831,2465,2670,728,404,324,1911
"2011","Mid Sussex","E14000817",37619,7669,1688,5981,9811,2956,5204,3235,3035,2738,771,429,342,2200
"2011","Milton Keynes North","E14000821",45118,7265,1373,5892,9905,3639,5162,4163,4425,5696,1696,775,921,3167
"2011","Milton Keynes South","E14000822",44920,7163,1343,5820,9466,3438,5029,4456,4547,6023,1742,863,879,3056
"2011","Mole Valley","E14000824",33340,7704,1864,5840,8772,1906,5750,2319,2108,2031,739,394,345,2011
"2011","New Forest East","E14000827",32654,4664,1114,3550,7178,2180,4576,4485,2987,3980,916,546,370,1688
"2011","New Forest West","E14000828",27816,4596,1160,3436,6208,1441,5350,2717,2656,2722,693,401,292,1433
"2011","Newbury","E14000830",39142,8268,1734,6534,9077,2303,5265,3558,3507,4076,948,466,482,2140
"2011","North East Hampshire","E14000844",34687,9189,2303,6886,9658,2327,4388,2669,2013,1926,545,268,277,1972
"2011","North Thanet","E14000852",31718,3065,768,2297,5683,2120,5712,3502,3711,4091,1765,1029,736,2069
"2011","North West Hampshire","E14000857",36524,6929,1904,5025,8206,2388,4871,3823,3465,4109,811,441,370,1922
"2011","Oxford East","E14000873",47227,7180,712,6468,6746,2127,3417,3120,4519,4758,1766,1028,738,13594
"2011","Oxford West and Abingdon","E14000874",39157,9043,1332,7711,8286,2083,3874,3141,2848,3381,839,473,366,5662
"2011","Portsmouth North","E14000883",34629,3815,955,2860,6323,2690,5236,3936,3864,4909,1324,701,623,2532
"2011","Portsmouth South","E14000884",43996,4849,1130,3719,7128,2968,4224,3405,3721,4448,1828,936,892,11425
"2011","Reading East","E14000889",42340,8795,1163,7632,9147,2700,4146,2812,3472,3243,1476,774,702,6549
"2011","Reading West","E14000890",36667,5912,921,4991,7461,2690,4768,3520,3937,4678,1481,798,683,2220
"2011","Reigate","E14000893",35678,7629,1594,6035,9224,2628,5388,2591,2497,2502,1125,748,377,2094
"2011","Rochester and Strood","E14000898",39446,4186,1083,3103,7626,3291,5493,4600,3990,5514,1908,1151,757,2838
"2011","Romsey and Southampton North","E14000901",33067,6517,1412,5105,6759,1742,3980,2516,2389,2879,738,443,295,5547
"2011","Runnymede and Weybridge","E14000907",36868,7345,1844,5501,8922,2319,5114,2947,2478,2749,892,467,425,4102
"2011","Sevenoaks","E14000918",32553,6546,1594,4952,7685,2252,5419,2702,2406,2735,754,361,393,2054
"2011","Sittingbourne and Sheppey","E14000927",39356,3635,1048,2587,6836,2749,6028,4836,4327,6489,2250,1424,826,2206
"2011","Slough","E14000930",48029,5210,751,4459,8045,3532,6421,5023,6216,6294,2510,1429,1081,4778
"2011","South Thanet","E14000948",33261,3359,750,2609,6071,2046,5618,3501,3747,4322,1944,1040,904,2653
"2011","South West Surrey","E14000953",35748,8588,1929,6659,9443,1805,5284,2482,2415,2169,793,415,378,2769
"2011","Southampton, Itchen","E14000955",39043,3654,659,2995,6334,2502,4964,4225,4525,5816,1613,853,760,5410
"2011","Southampton, Test","E14000956",41612,4639,574,4065,6029,2557,4348,3717,4791,6193,1780,1005,775,7558
"2011","Spelthorne","E14000959",34663,5306,1049,4257,8129,3295,4769,3940,2788,3627,896,479,417,1913
"2011","Surrey Heath","E14000983",38553,8440,2075,6365,10018,2700,5375,3303,2724,2763,938,567,371,2292
"2011","Tonbridge and Malling","E14000997",34386,6520,1584,4936,8274,2250,5310,2888,2820,3066,934,542,392,2324
"2011","Tunbridge Wells","E14001004",37716,7137,1592,5545,9453,2430,5662,2980,3219,3297,1058,575,483,2480
"2011","Wantage","E14001015",38409,8310,2051,6259,8645,2318,4867,3727,3101,4568,855,433,422,2018
"2011","Wealden","E14001023",35278,6251,1552,4699,8470,1990,7061,2846,2761,2873,866,517,349,2160
"2011","Winchester","E14001041",34215,8355,1733,6622,8230,1868,3875,2384,2393,2531,713,387,326,3866
"2011","Windsor","E14001042",36689,8246,2068,6178,10214,2447,4639,3004,2283,2448,761,382,379,2647
"2011","Witney","E14001046",37745,6899,1828,5071,8646,2372,5470,4055,3268,4380,688,372,316,1967
"2011","Woking","E14001047",38543,8642,1912,6730,9930,2702,5036,3034,3055,2611,1063,546,517,2470
"2011","Wokingham","E14001048",36557,10031,1960,8071,10047,2471,4195,2480,2119,2074,796,435,361,2344
"2011","Worthing West","E14001055",32045,4721,1096,3625,7190,2870,5022,3128,3107,3090,1071,589,482,1846
"2011","Wycombe","E14001056",39413,6781,1548,5233,8620,2337,5463,3305,3800,3771,1316,692,624,4020
"2011","Bath","E14000547",33739,5893,957,4936,6674,1720,3520,2148,2636,2641,882,485,397,7625
"2011","Bournemouth East","E14000584",38621,4927,890,4037,7766,2690,6045,3413,4342,4175,1596,889,707,3667
"2011","Bournemouth West","E14000585",37766,4046,803,3243,6757,2401,5319,3647,4089,4355,1262,700,562,5890
"2011","Bridgwater and West Somerset","E14000595",38029,3958,1030,2928,6489,1863,6971,4345,4979,6126,1252,704,548,2046
"2011","Bristol East","E14000599",34967,3619,640,2979,6075,2738,4487,3896,4441,5328,1567,921,646,2816
"2011","Bristol North West","E14000600",35427,6186,929,5257,6310,2144,3456,3160,3690,4981,1532,905,627,3968
"2011","Bristol South","E14000601",38791,4112,628,3484,6866,2937,4622,4458,4827,6605,1968,1114,854,2396
"2011","Bristol West","E14000602",53147,10685,1126,9559,10207,3182,4194,2642,3765,3545,2454,1456,998,12473
"2011","Camborne and Redruth","E14000616",30578,2568,656,1912,5210,1672,5460,3679,3833,4727,1105,675,430,2324
"2011","Central Devon","E14000623",31530,4546,1029,3517,6359,1602,7164,2934,3049,3548,797,490,307,1531
"2011","Cheltenham","E14000630",38758,6703,1381,5322,9028,3176,4500,2983,3816,3411,1255,642,613,3886
"2011","Chippenham","E14000635",33899,6094,1417,4677,7418,2191,4085,3491,3645,4028,854,419,435,2093
"2011","Christchurch","E14000638",27723,4415,1107,3308,6221,1804,4976,2737,2663,2771,668,363,305,1468
"2011","Devizes","E14000665",36923,6031,2451,3580,9146,3904,4556,3801,2930,3872,793,482,311,1890
"2011","East Devon","E14000678",32048,4947,1202,3745,7276,2790,5502,2940,2891,3281,715,427,288,1706
"2011","Exeter","E14000698",39984,4751,710,4041,6736,2946,4028,3467,4020,5049,1267,732,535,7720
"2011","Filton and Bradley Stoke","E14000702",34715,6474,1098,5376,6926,2749,3622,3684,3224,3639,790,426,364,3607
"2011","Forest of Dean","E14000705",31579,4026,1085,2941,5777,1747,5602,3334,3520,4278,1195,696,499,2100
"2011","Gloucester","E14000712",40825,4475,1060,3415,7527,3061,4268,4718,5725,6139,1992,1179,813,2920
"2011","Kingswood","E14000774",31229,4257,974,3283,6226,2622,4246,3768,3323,4138,801,402,399,1848
"2011","Mid Dorset and North Poole","E14000815",28284,4792,1190,3602,6164,1964,4080,3089,2815,3089,549,276,273,1742
"2011","Newton Abbot","E14000835",30262,3610,872,2738,6051,2006,5292,3259,3276,4059,996,641,355,1713
"2011","North Cornwall","E14000837",31019,3085,814,2271,5087,1381,7660,3522,3585,4087,938,585,353,1674
"2011","North Devon","E14000838",33224,3385,926,2459,6155,1802,7160,3708,3833,4480,876,485,391,1825
"2011","North Dorset","E14000839",34128,5091,1492,3599,7423,2123,6303,3491,3007,4033,685,444,241,1972
"2011","North East Somerset","E14000846",30698,4914,1102,3812,6238,1775,4938,3195,3090,3684,750,429,321,2114
"2011","North Somerset","E14000850",34768,7329,1524,5805,8522,2477,4814,3172,2698,3214,636,342,294,1906
"2011","North Swindon","E14000851",39139,5304,1178,4126,7744,2785,4289,4932,5055,5835,1172,597,575,2023
"2011","North Wiltshire","E14000860",31897,6421,1919,4502,7551,2076,4760,2963,2610,3198,636,338,298,1682
"2011","Plymouth, Moor View","E14000879",31770,2488,716,1772,4997,2415,3583,4077,4127,6245,1617,1004,613,2221
"2011","Plymouth, Sutton and Devonport","E14000880",45101,3953,826,3127,7139,3301,4439,4164,4621,6028,2193,1275,918,9263
"2011","Poole","E14000881",34232,4871,1131,3740,7130,2239,5247,3672,3729,4342,1054,583,471,1948
"2011","Salisbury","E14000912",31843,5979,1671,4308,6966,2141,4737,3156,2793,3620,800,469,331,1651
"2011","Somerton and Frome","E14000932",36373,5411,1470,3941,7197,1614,7237,3911,3676,4417,878,487,391,2032
"2011","South Dorset","E14000936",34049,3997,1092,2905,6740,2451,5308,4158,3849,4393,1392,871,521,1761
"2011","South East Cornwall","E14000938",31706,3788,1046,2742,6345,1894,6508,3471,3222,3894,795,419,376,1789
"2011","South Swindon","E14000947",38615,5687,1110,4577,7376,2920,4037,4071,4855,5772,1545,756,789,2352
"2011","South West Devon","E14000950",31153,4682,1307,3375,7221,2656,4275,3545,2751,3535,622,358,264,1866
"2011","South West Wiltshire","E14000954",34300,4854,1497,3357,6935,2228,5246,3871,3664,4691,1002,541,461,1809
"2011","St Austell and Newquay","E14000961",35143,2859,816,2043,5993,1866,6692,5047,4093,5347,1238,723,515,2008
"2011","St Ives","E14000964",30353,3002,799,2203,6058,1723,6830,3564,3178,3480,912,524,388,1606
"2011","Stroud","E14000980",36309,6135,1425,4710,7685,1888,5669,3728,3895,4142,988,533,455,2179
"2011","Taunton Deane","E14000988",38578,5207,1239,3968,8132,3082,5614,3742,4256,4805,1117,715,402,2623
"2011","Tewkesbury","E14000990",35327,5938,1540,4398,8108,2759,4709,3631,3722,3623,864,463,401,1973
"2011","The Cotswolds","E14000991",33903,6614,1838,4776,7443,1429,6027,3043,3039,3371,717,381,336,2220
"2011","Thornbury and Yate","E14000994",30433,5394,1149,4245,6415,1973,4294,3347,2822,3688,669,425,244,1831
"2011","Tiverton and Honiton","E14000996",33796,4214,1066,3148,6330,1752,7199,3705,3497,4609,825,496,329,1665
"2011","Torbay","E14000999",34293,2974,722,2252,6100,2231,6526,3668,4148,5044,1640,894,746,1962
"2011","Torridge and West Devon","E14001000",34802,3975,1035,2940,6227,1650,8033,3651,3897,4481,1086,621,465,1802
"2011","Totnes","E14001001",28743,3828,1129,2699,5646,1329,6773,2621,2789,3344,825,472,353,1588
"2011","Truro and Falmouth","E14001003",31665,4486,1010,3476,6198,1719,5642,3021,3071,3430,819,416,403,3279
"2011","Wells","E14001026",36441,4871,1130,3741,7059,1749,6530,3798,3757,5071,1049,668,381,2557
"2011","West Dorset","E14001031",32902,5073,1267,3806,7001,1749,6411,3316,3189,3539,743,442,301,1881
"2011","Weston-Super-Mare","E14001038",36634,4608,1060,3548,7400,2379,5405,3992,4158,5060,1416,829,587,2216
"2011","Yeovil","E14001060",38499,5217,1460,3757,7099,2395,5342,5535,4884,5218,1007,576,431,1802
"2011","Ynys Mon","W07000041",25392,2809,737,2072,4439,1388,4223,3249,2821,3585,1209,592,617,1669
"2011","Delyn","W07000042",25539,2958,801,2157,4476,1348,3273,3825,3096,4081,903,494,409,1579
"2011","Alyn and Deeside","W07000043",30304,3238,888,2350,5203,1822,3318,5154,4035,4624,1050,521,529,1860
"2011","Wrexham","W07000044",26258,2743,746,1997,4235,1532,2620,3368,4092,4063,1231,702,529,2374
"2011","Llanelli","W07000045",28644,2441,614,1827,4766,1921,3412,3543,3982,5183,1521,878,643,1875
"2011","Gower","W07000046",27275,4013,878,3135,5914,2150,3475,2994,2713,3268,914,529,385,1834
"2011","Swansea West","W07000047",32338,3348,564,2784,4924,2084,2722,2463,2991,3561,1615,1036,579,8630
"2011","Swansea East","W07000048",28725,2083,435,1648,4424,2436,2861,3855,4085,5397,1587,1020,567,1997
"2011","Aberavon","W07000049",24080,1590,420,1170,3450,1490,2106,3943,3196,5432,1412,911,501,1461
"2011","Cardiff Central","W07000050",36556,4337,584,3753,5558,2544,2587,2196,2782,2716,1831,1150,681,12005
"2011","Cardiff North","W07000051",31120,6166,1063,5103,7006,2752,3153,2361,2448,2362,1159,666,493,3713
"2011","Rhondda","W07000052",25177,1341,425,916,3165,1534,2937,3278,3608,5520,1878,1151,727,1916
"2011","Torfaen","W07000053",29108,2427,653,1774,4547,1949,2913,3867,4270,5803,1561,890,671,1771
"2011","Monmouth","W07000054",29867,5270,1328,3942,6312,1572,4812,2749,2658,3536,1066,640,426,1892
"2011","Newport East","W07000055",27728,2639,703,1936,4414,1828,2848,3453,3298,5223,1629,960,669,2396
"2011","Newport West","W07000056",30450,3882,890,2992,5685,2329,2995,3376,3506,4433,1713,969,744,2531
"2011","Arfon","W07000057",22474,2097,366,1731,3682,1307,2902,2231,2081,2812,929,499,430,4433
"2011","Aberconwy","W07000058",19849,2096,431,1665,3891,1172,3600,2112,2306,2527,848,441,407,1297
"2011","Clwyd West","W07000059",25976,2818,643,2175,4897,1521,4946,2599,2870,3347,1190,615,575,1788
"2011","Vale of Clwyd","W07000060",24937,2209,509,1700,4189,1505,3616,2925,3333,3984,1392,838,554,1784
"2011","Dwyfor Meirionnydd","W07000061",22000,1999,471,1528,3797,1003,5464,2443,2431,2913,790,422,368,1160
"2011","Clwyd South","W07000062",26052,2323,628,1695,4159,1352,3773,3604,3816,4289,1137,634,503,1599
"2011","Montgomeryshire","W07000063",23146,2292,568,1724,3867,1000,6012,2431,2620,3053,642,372,270,1229
"2011","Ceredigion","W07000064",28932,2871,452,2419,4304,1280,6253,2352,2440,2821,837,502,335,5774
"2011","Preseli Pembrokeshire","W07000065",27176,2338,516,1822,4973,1509,5699,3290,2934,3929,1059,612,447,1445
"2011","Carmarthen West and South Pembrokeshire","W07000066",27383,2477,542,1935,4739,1511,5600,3301,2947,3805,1118,691,427,1885
"2011","Carmarthen East and Dinefwr","W07000067",25485,2533,598,1935,4436,1481,5527,2574,2450,3957,964,567,397,1563
"2011","Brecon and Radnorshire","W07000068",24842,2646,674,1972,4444,1394,6305,2486,2478,2977,764,428,336,1348
"2011","Neath","W07000069",26968,2351,621,1730,4587,1833,2899,3713,3300,5320,1283,789,494,1682
"2011","Cynon Valley","W07000070",24643,1725,495,1230,3591,1628,2867,3238,3165,5169,1543,920,623,1717
"2011","Merthyr Tydfil and Rhymney","W07000071",27349,1643,491,1152,3705,1825,2737,3685,3650,6293,2054,1200,854,1757
"2011","Blaenau Gwent","W07000072",25773,1434,481,953,3120,1379,2421,3613,4132,6119,2054,1093,961,1501
"2011","Bridgend","W07000073",29387,3516,894,2622,5809,2020,3249,3730,3352,4309,1614,1040,574,1788
"2011","Ogmore","W07000074",27373,2122,566,1556,4111,1760,3038,3745,3753,5749,1515,874,641,1580
"2011","Pontypridd","W07000075",29632,3258,784,2474,5450,2121,3380,3392,3055,4169,1290,734,556,3517
"2011","Caerphilly","W07000076",31184,2951,710,2241,5347,2438,3407,3957,3741,5504,1957,1137,820,1882
"2011","Islwyn","W07000077",27369,2220,719,1501,4213,1869,2836,3782,3753,5611,1479,810,669,1606
"2011","Vale of Glamorgan","W07000078",34927,4696,1255,3441,7327,2863,4263,4144,3361,4187,1683,884,799,2403
"2011","Cardiff West","W07000079",32434,4720,786,3934,6636,2464,3499,2945,3389,4086,1993,1293,700,2702
"2011","Cardiff South and Penarth","W07000080",38987,5189,860,4329,7710,3236,4024,3806,4266,4827,2602,1620,982,3327
"2011","Aberdeen North","S14000001",39550,4474,563,3911,5621,2265,2250,4942,4539,6637,1293,706,587,7529
"2011","Aberdeen South","S14000002",36492,7721,1251,6470,7157,2316,2614,4370,3378,4172,862,532,330,3902
"2011","Airdrie and Shotts","S14000003",31279,1998,496,1502,4480,2304,3011,4273,4001,7321,2096,1099,997,1795
"2011","Angus","S14000004",31087,2705,746,1959,5257,1783,3871,4735,4084,5465,1354,693,661,1833
"2011","Argyll and Bute","S14000005",32293,3357,932,2425,6546,2582,5595,3761,3365,4431,1096,518,578,1560
"2011","Ayr, Carrick and Cumnock","S14000006",33331,2869,680,2189,5516,2015,3994,4773,4157,6024,1919,1005,914,2064
"2011","Banff and Buchan","S14000007",34052,2692,764,1928,5234,1539,5098,6053,4108,6780,970,562,408,1578
"2011","Berwickshire, Roxburgh and Selkirk","S14000008",34145,3447,993,2454,5963,1971,5851,4009,4430,5603,1279,665,614,1592
"2011","Caithness, Sutherland and Easter Ross","S14000009",22748,1995,402,1593,3763,1167,3546,3641,2696,3977,959,502,457,1004
"2011","Central Ayrshire","S14000010",31290,2967,692,2275,5694,2210,3240,4674,3771,4956,1695,830,865,2083
"2011","Coatbridge, Chryston and Bellshill","S14000011",34128,2521,603,1918,5360,2741,3361,4544,4480,7029,1986,1030,956,2106
"2011","Cumbernauld, Kilsyth and Kirkintilloch East","S14000012",31427,2790,688,2102,5481,2742,3353,3962,3782,5451,1496,690,806,2370
"2011","Dumfries and Galloway","S14000013",34692,2606,637,1969,5281,2008,6114,4301,5209,6079,1473,796,677,1621
"2011","Dumfriesshire, Clydesdale and Tweeddale","S14000014",30803,3260,780,2480,5172,1528,5380,3842,3924,5187,1122,565,557,1388
"2011","Dundee East","S14000015",30728,3324,717,2607,5888,2413,2937,3647,3530,4555,1646,863,783,2788
"2011","Dundee West","S14000016",33663,2755,378,2377,4560,2228,2480,3480,3973,5091,2272,1224,1048,6824
"2011","Dunfermline and West Fife","S14000017",36187,4418,908,3510,7425,3404,3046,4522,3993,5664,1658,765,893,2057
"2011","East Dunbartonshire","S14000018",28740,6007,1045,4962,6954,2370,3267,2463,2028,2108,825,446,379,2718
"2011","East Kilbride, Strathaven and Lesmahagow","S14000019",36290,4267,896,3371,7061,3238,3939,4414,3800,5486,1453,721,732,2632
"2011","East Lothian","S14000020",35096,4458,912,3546,6761,2498,4376,4209,3940,5331,1301,710,591,2222
"2011","East Renfrewshire","S14000021",31048,5967,1191,4776,7223,2469,3533,2667,2481,2489,1139,604,535,3080
"2011","Edinburgh East","S14000022",37377,4356,546,3810,6246,2885,3151,3120,3709,4026,1840,1029,811,8044
"2011","Edinburgh North and Leith","S14000023",42645,8844,1175,7669,9917,3212,3501,3373,3590,3883,1670,854,816,4655
"2011","Edinburgh South","S14000024",31369,6989,847,6142,6140,1892,2688,1957,2227,2311,988,564,424,6177
"2011","Edinburgh South West","S14000025",39663,6298,877,5421,7467,3281,3003,3273,3776,4035,1888,1135,753,6642
"2011","Edinburgh West","S14000026",31259,6029,1063,4966,7072,2784,3078,2709,2833,3136,1089,569,520,2529
"2011","Falkirk","S14000028",39797,3773,892,2881,7439,3127,3810,5920,4331,7304,1921,933,988,2172
"2011","Glasgow Central","S14000029",40086,4117,400,3717,6018,2711,2559,3172,4097,4503,3007,1866,1141,9902
"2011","Glasgow East","S14000030",30755,1442,299,1143,3622,2053,2919,3706,4571,6933,3110,1893,1217,2399
"2011","Glasgow North","S14000031",28766,4298,435,3863,4913,1853,1778,2152,2601,2722,1747,991,756,6702
"2011","Glasgow North East","S14000032",31392,1570,202,1368,3446,2133,2168,3580,4943,6443,3860,2567,1293,3249
"2011","Glasgow North West","S14000033",30835,3712,471,3241,5198,2345,2385,3024,3779,4529,2828,1678,1150,3035
"2011","Glasgow South","S14000034",32680,4221,565,3656,6380,2848,3140,3115,3683,4296,2313,1315,998,2684
"2011","Glasgow South West","S14000035",29104,1615,290,1325,3746,2320,2276,3533,4529,5839,2813,1637,1176,2433
"2011","Glenrothes","S14000036",31938,1976,548,1428,4632,2088,2894,4897,5109,6476,1962,975,987,1904
"2011","Gordon","S14000037",37329,6160,1399,4761,7809,2414,4180,5698,3469,4896,603,334,269,2100
"2011","Inverclyde","S14000038",29402,2682,569,2113,4810,2691,2294,3321,3922,5814,1653,1020,633,2215
"2011","Inverness, Nairn, Badenoch and Strathspey","S14000039",36971,3980,891,3089,7373,2575,4698,5248,4293,5852,1193,634,559,1759
"2011","Kilmarnock and Loudoun","S14000040",35129,2957,675,2282,5670,2484,3958,4924,4589,6131,2168,1105,1063,2248
"2011","Kirkcaldy and Cowdenbeath","S14000041",34668,3341,733,2608,6098,2662,3141,4575,4293,6545,2052,969,1083,1961
"2011","Lanark and Hamilton East","S14000042",35770,4085,927,3158,6788,2750,3975,4293,3769,6106,1903,1023,880,2101
"2011","Linlithgow and East Falkirk","S14000043",40818,4294,984,3310,7551,2961,3568,5587,4904,7981,1887,975,912,2085
"2011","Livingston","S14000044",40226,3965,865,3100,6808,3422,3499,5178,5216,7884,1844,1068,776,2410
"2011","Midlothian","S14000045",29759,3032,592,2440,5260,2549,3357,3857,3660,5103,1260,709,551,1681
"2011","Moray","S14000046",34015,2789,999,1790,6645,2465,3999,5465,4449,5645,999,523,476,1559
"2011","Motherwell and Wishaw","S14000047",33215,2449,602,1847,5202,2790,2734,4482,4502,6740,2196,1068,1128,2120
"2011","Na h-Eileanan An Iar","S14000027",10246,766,174,592,1856,632,1702,1406,1064,2018,358,129,229,444
"2011","North Ayrshire and Arran","S14000048",33827,3111,679,2432,5671,2217,3676,5085,4050,5441,2303,1090,1213,2273
"2011","North East Fife","S14000049",29624,4270,895,3375,5597,1723,3535,3052,2532,3132,836,457,379,4947
"2011","Ochil and South Perthshire","S14000050",36320,4541,1143,3398,6868,2209,4475,4639,4091,5675,1621,927,694,2201
"2011","Orkney and Shetland","S14000051",16720,1256,305,951,3136,743,2900,2490,2144,3078,320,183,137,653
"2011","Paisley and Renfrewshire North","S14000052",31814,3597,845,2752,6259,2680,2695,4279,3742,4622,1512,859,653,2428
"2011","Paisley and Renfrewshire South","S14000053",31530,2951,671,2280,5421,2562,2702,3910,4084,5247,2039,1000,1039,2614
"2011","Perth and North Perthshire","S14000054",35694,4324,928,3396,6541,2452,4592,4610,4256,5473,1350,848,502,2096
"2011","Ross, Skye and Lochaber","S14000055",24667,2450,522,1928,4599,1288,4811,3402,2681,3805,585,288,297,1046
"2011","Rutherglen and Hamilton West","S14000056",37180,3408,682,2726,6319,3230,3806,4776,4575,6473,2331,1227,1104,2262
"2011","Stirling","S14000057",32249,4940,1073,3867,6202,1804,3671,3386,2926,4038,1256,695,561,4026
"2011","West Aberdeenshire and Kincardine","S14000058",33560,6548,1557,4991,7247,1938,4197,4536,2920,3682,515,294,221,1977
"2011","West Dunbartonshire","S14000059",32493,2132,489,1643,4994,3010,2760,4539,4686,5933,2249,1124,1125,2190
"2011","Belfast East","N06000001",32478,4312,731,3581,6173,3292,2743,3316,3959,4398,1845,1030,815,2440
"2011","Belfast North","N06000002",35466,2742,436,2306,4975,2902,2808,3672,5024,6436,3756,2362,1394,3151
"2011","Belfast South","N06000003",42340,7892,807,7085,7962,3684,2745,2901,3694,3731,2220,1314,906,7511
"2011","Belfast West","N06000004",31513,1594,243,1351,3819,2495,2620,2929,4465,5620,4449,3080,1369,3522
"2011","East Antrim","N06000005",32365,3444,718,2726,5552,2826,3749,3869,3433,4667,1548,774,774,3277
"2011","East Londonderry","N06000006",36147,2904,523,2381,5016,2589,6327,3342,3669,5781,2878,1621,1257,3641
"2011","Fermanagh & South Tyrone","N06000007",37378,2609,543,2066,4508,1969,7373,3633,4661,7005,2566,1526,1040,3054
"2011","Foyle","N06000008",35670,2777,591,2186,5344,2719,3588,3302,4330,5217,4403,2671,1732,3990
"2011","Lagan Valley","N06000009",36511,4913,1038,3875,7102,3363,4963,3530,3590,4688,1467,760,707,2895
"2011","Mid Ulster","N06000010",35535,2481,579,1902,4060,1431,7763,3516,3279,7359,2398,1467,931,3248
"2011","Newry & Armagh","N06000011",40200,2818,621,2197,5261,2231,7351,3842,4110,7500,3547,1988,1559,3540
"2011","North Antrim","N06000012",39008,3218,746,2472,5418,2154,7258,4292,4941,6490,2265,1264,1001,2972
"2011","North Down","N06000013",31764,4501,955,3546,7345,3857,3621,2876,3023,2866,1259,602,657,2416
"2011","South Antrim","N06000014",35160,3537,795,2742,6413,3012,4934,3955,3678,5267,1563,875,688,2801
"2011","South Down","N06000015",38844,3153,610,2543,5712,2200,8977,3315,3275,6155,2674,1472,1202,3383
"2011","Strangford","N06000016",32181,3190,667,2523,5528,3053,5609,3272,3253,4293,1526,733,793,2457
"2011","Upper Bann","N06000017",42025,3587,805,2782,6165,2987,5419,4562,5747,7329,2608,1333,1275,3621
"2011","West Tyrone","N06000018",32784,2012,368,1644,3959,1635,6863,2818,3273,6120,3281,2032,1249,2823
